Time,Date,Day of the week,CarCount,BikeCount,BusCount,TruckCount,Total,Traffic Situation
12:00:00 AM,10,Tuesday,137,14,41,10,202,heavy
12:15:00 AM,10,Tuesday,122,21,20,10,173,heavy
12:30:00 AM,10,Tuesday,104,19,39,9,171,heavy
12:45:00 AM,10,Tuesday,147,21,40,9,217,heavy
1:00:00 AM,10,Tuesday,105,38,34,7,184,heavy
1:15:00 AM,10,Tuesday,124,23,46,5,198,heavy
1:30:00 AM,10,Tuesday,135,18,20,5,178,heavy
1:45:00 AM,10,Tuesday,107,35,23,8,173,heavy
2:00:00 AM,10,Tuesday,109,21,24,10,164,normal
2:15:00 AM,10,Tuesday,136,32,26,8,202,heavy
2:30:00 AM,10,Tuesday,134,23,49,8,214,heavy
2:45:00 AM,10,Tuesday,90,20,11,25,146,high
3:00:00 AM,10,Tuesday,104,5,16,16,141,normal
3:15:00 AM,10,Tuesday,60,21,13,6,100,low
3:30:00 AM,10,Tuesday,104,22,11,13,150,normal
3:45:00 AM,10,Tuesday,54,23,10,25,112,high
4:00:00 AM,10,Tuesday,68,6,15,34,123,high
4:15:00 AM,10,Tuesday,88,13,19,19,139,normal
4:30:00 AM,10,Tuesday,64,22,16,16,118,normal
4:45:00 AM,10,Tuesday,58,24,14,24,120,high
5:00:00 AM,10,Tuesday,67,19,12,9,107,low
5:15:00 AM,10,Tuesday,73,20,18,7,118,normal
5:30:00 AM,10,Tuesday,109,25,16,20,170,heavy
5:45:00 AM,10,Tuesday,63,15,11,23,112,high
6:00:00 AM,10,Tuesday,19,4,1,26,50,normal
6:15:00 AM,10,Tuesday,15,1,0,34,50,normal
6:30:00 AM,10,Tuesday,15,5,1,14,35,normal
6:45:00 AM,10,Tuesday,19,3,1,33,56,normal
7:00:00 AM,10,Tuesday,18,4,0,11,33,low
7:15:00 AM,10,Tuesday,14,1,0,27,42,normal
7:30:00 AM,10,Tuesday,19,0,0,37,56,normal
7:45:00 AM,10,Tuesday,19,0,0,29,48,normal
8:00:00 AM,10,Tuesday,18,1,0,30,49,normal
8:15:00 AM,10,Tuesday,19,3,0,18,40,normal
8:30:00 AM,10,Tuesday,15,2,1,34,52,normal
8:45:00 AM,10,Tuesday,17,0,1,14,32,normal
9:00:00 AM,10,Tuesday,12,0,0,33,45,normal
9:15:00 AM,10,Tuesday,20,0,1,20,41,normal
9:30:00 AM,10,Tuesday,10,2,0,18,30,normal
9:45:00 AM,10,Tuesday,13,3,0,31,47,normal
10:00:00 AM,10,Tuesday,10,0,1,38,49,normal
10:15:00 AM,10,Tuesday,19,1,1,28,49,normal
10:30:00 AM,10,Tuesday,19,4,0,16,39,normal
10:45:00 AM,10,Tuesday,16,1,0,15,32,normal
11:00:00 AM,10,Tuesday,17,1,0,34,52,normal
11:15:00 AM,10,Tuesday,19,1,0,21,41,normal
11:30:00 AM,10,Tuesday,10,1,0,39,50,normal
11:45:00 AM,10,Tuesday,16,4,0,15,35,normal
12:00:00 PM,10,Tuesday,13,0,0,16,29,normal
12:15:00 PM,10,Tuesday,98,5,1,17,121,normal
12:30:00 PM,10,Tuesday,65,10,3,8,86,low
12:45:00 PM,10,Tuesday,98,17,0,20,135,normal
1:00:00 PM,10,Tuesday,60,20,5,6,91,low
1:15:00 PM,10,Tuesday,110,18,10,11,149,normal
1:30:00 PM,10,Tuesday,70,13,4,13,100,normal
1:45:00 PM,10,Tuesday,96,12,7,17,132,normal
2:00:00 PM,10,Tuesday,129,31,36,1,197,heavy
2:15:00 PM,10,Tuesday,146,28,47,3,224,heavy
2:30:00 PM,10,Tuesday,137,23,27,0,187,heavy
2:45:00 PM,10,Tuesday,131,28,24,0,183,heavy
3:00:00 PM,10,Tuesday,134,10,44,0,188,heavy
3:15:00 PM,10,Tuesday,109,25,24,0,158,normal
3:30:00 PM,10,Tuesday,108,35,22,3,168,heavy
3:45:00 PM,10,Tuesday,146,14,37,2,199,heavy
4:00:00 PM,10,Tuesday,147,21,41,5,214,heavy
4:15:00 PM,10,Tuesday,110,34,35,0,179,heavy
4:30:00 PM,10,Tuesday,110,40,50,2,202,heavy
4:45:00 PM,10,Tuesday,123,12,22,3,160,normal
5:00:00 PM,10,Tuesday,145,25,20,5,195,heavy
5:15:00 PM,10,Tuesday,82,15,16,29,142,high
5:30:00 PM,10,Tuesday,62,2,7,22,93,normal
5:45:00 PM,10,Tuesday,92,8,11,21,132,high
6:00:00 PM,10,Tuesday,35,22,22,18,97,normal
6:15:00 PM,10,Tuesday,66,25,13,13,117,normal
6:30:00 PM,10,Tuesday,50,2,25,12,89,normal
6:45:00 PM,10,Tuesday,50,22,24,7,103,normal
7:00:00 PM,10,Tuesday,50,8,5,24,87,normal
7:15:00 PM,10,Tuesday,55,5,5,21,86,normal
7:30:00 PM,10,Tuesday,51,10,14,24,99,normal
7:45:00 PM,10,Tuesday,34,8,14,21,77,normal
8:00:00 PM,10,Tuesday,25,7,5,20,57,normal
8:15:00 PM,10,Tuesday,59,7,9,21,96,normal
8:30:00 PM,10,Tuesday,38,10,9,24,81,normal
8:45:00 PM,10,Tuesday,70,10,9,23,112,high
9:00:00 PM,10,Tuesday,63,8,13,22,106,normal
9:15:00 PM,10,Tuesday,6,24,12,13,55,normal
9:30:00 PM,10,Tuesday,108,17,16,16,157,normal
9:45:00 PM,10,Tuesday,41,20,32,12,105,normal
10:00:00 PM,10,Tuesday,54,10,20,9,93,normal
10:15:00 PM,10,Tuesday,60,19,14,7,100,low
10:30:00 PM,10,Tuesday,102,11,9,11,133,normal
10:45:00 PM,10,Tuesday,50,24,30,5,109,normal
11:00:00 PM,10,Tuesday,25,24,19,10,78,normal
11:15:00 PM,10,Tuesday,90,25,18,20,153,normal
11:30:00 PM,10,Tuesday,86,13,27,11,137,high
11:45:00 PM,10,Tuesday,44,19,17,9,89,normal
12:00:00 AM,11,Wednesday,126,24,35,8,193,heavy
12:15:00 AM,11,Wednesday,146,26,42,9,223,normal
12:30:00 AM,11,Wednesday,117,28,33,10,188,heavy
12:45:00 AM,11,Wednesday,144,36,49,10,239,heavy
1:00:00 AM,11,Wednesday,137,19,23,9,188,heavy
1:15:00 AM,11,Wednesday,118,19,48,5,190,heavy
1:30:00 AM,11,Wednesday,119,27,28,8,182,heavy
1:45:00 AM,11,Wednesday,149,26,43,5,223,normal
2:00:00 AM,11,Wednesday,117,34,36,10,197,heavy
2:15:00 AM,11,Wednesday,124,30,44,10,208,heavy
2:30:00 AM,11,Wednesday,141,36,48,5,230,heavy
2:45:00 AM,11,Wednesday,78,6,11,28,123,high
3:00:00 AM,11,Wednesday,102,23,16,24,165,high
3:15:00 AM,11,Wednesday,104,18,18,23,163,high
3:30:00 AM,11,Wednesday,95,9,19,7,130,normal
3:45:00 AM,11,Wednesday,105,13,12,20,150,normal
4:00:00 AM,11,Wednesday,100,18,16,34,168,heavy
4:15:00 AM,11,Wednesday,80,14,20,15,129,normal
4:30:00 AM,11,Wednesday,86,8,19,7,120,normal
4:45:00 AM,11,Wednesday,108,20,14,15,157,normal
5:00:00 AM,11,Wednesday,69,13,13,8,103,low
5:15:00 AM,11,Wednesday,64,14,10,6,94,low
5:30:00 AM,11,Wednesday,71,14,17,10,112,normal
5:45:00 AM,11,Wednesday,61,9,18,24,112,high
6:00:00 AM,11,Wednesday,11,4,0,31,46,normal
6:15:00 AM,11,Wednesday,17,5,0,14,36,normal
6:30:00 AM,11,Wednesday,15,5,0,18,38,normal
6:45:00 AM,11,Wednesday,14,2,0,40,56,normal
7:00:00 AM,11,Wednesday,12,2,1,28,43,normal
7:15:00 AM,11,Wednesday,18,0,1,40,59,normal
7:30:00 AM,11,Wednesday,14,5,0,13,32,normal
7:45:00 AM,11,Wednesday,18,1,0,26,45,normal
8:00:00 AM,11,Wednesday,14,0,0,34,48,normal
8:15:00 AM,11,Wednesday,17,5,0,23,45,normal
8:30:00 AM,11,Wednesday,19,1,1,18,39,normal
8:45:00 AM,11,Wednesday,15,5,1,12,33,low
9:00:00 AM,11,Wednesday,13,2,1,26,42,normal
9:15:00 AM,11,Wednesday,15,3,0,32,50,normal
9:30:00 AM,11,Wednesday,15,0,1,13,29,normal
9:45:00 AM,11,Wednesday,18,5,1,12,36,low
10:00:00 AM,11,Wednesday,17,1,0,29,47,normal
10:15:00 AM,11,Wednesday,10,4,0,19,33,normal
10:30:00 AM,11,Wednesday,15,0,0,18,33,normal
10:45:00 AM,11,Wednesday,11,0,0,35,46,normal
11:00:00 AM,11,Wednesday,20,5,1,34,60,normal
11:15:00 AM,11,Wednesday,15,5,1,32,53,normal
11:30:00 AM,11,Wednesday,16,4,1,37,58,normal
11:45:00 AM,11,Wednesday,14,1,0,12,27,low
12:00:00 PM,11,Wednesday,16,4,0,18,38,normal
12:15:00 PM,11,Wednesday,56,21,3,0,80,low
12:30:00 PM,11,Wednesday,78,11,10,18,117,normal
12:45:00 PM,11,Wednesday,82,29,0,20,131,normal
1:00:00 PM,11,Wednesday,102,15,2,7,126,normal
1:15:00 PM,11,Wednesday,69,14,6,18,107,normal
1:30:00 PM,11,Wednesday,87,24,6,19,136,normal
1:45:00 PM,11,Wednesday,84,16,10,5,115,normal
2:00:00 PM,11,Wednesday,109,38,34,5,186,heavy
2:15:00 PM,11,Wednesday,147,38,23,3,211,heavy
2:30:00 PM,11,Wednesday,135,19,48,5,207,heavy
2:45:00 PM,11,Wednesday,101,23,41,5,170,heavy
3:00:00 PM,11,Wednesday,138,21,28,1,188,heavy
3:15:00 PM,11,Wednesday,136,20,32,1,189,heavy
3:30:00 PM,11,Wednesday,123,19,25,5,172,heavy
3:45:00 PM,11,Wednesday,108,30,46,5,189,heavy
4:00:00 PM,11,Wednesday,128,15,43,5,191,heavy
4:15:00 PM,11,Wednesday,129,37,41,1,208,heavy
4:30:00 PM,11,Wednesday,127,18,28,3,176,heavy
4:45:00 PM,11,Wednesday,142,37,46,3,228,heavy
5:00:00 PM,11,Wednesday,149,26,46,1,222,heavy
5:15:00 PM,11,Wednesday,77,13,7,23,120,high
5:30:00 PM,11,Wednesday,37,16,13,29,95,normal
5:45:00 PM,11,Wednesday,79,8,16,12,115,normal
6:00:00 PM,11,Wednesday,97,2,16,7,122,normal
6:15:00 PM,11,Wednesday,22,8,31,8,69,normal
6:30:00 PM,11,Wednesday,31,23,19,12,85,normal
6:45:00 PM,11,Wednesday,49,22,16,5,92,normal
7:00:00 PM,11,Wednesday,32,5,3,21,61,normal
7:15:00 PM,11,Wednesday,40,6,11,28,85,normal
7:30:00 PM,11,Wednesday,42,6,10,21,79,normal
7:45:00 PM,11,Wednesday,37,9,7,25,78,normal
8:00:00 PM,11,Wednesday,45,5,5,24,79,normal
8:15:00 PM,11,Wednesday,64,10,4,28,106,normal
8:30:00 PM,11,Wednesday,33,8,6,23,70,normal
8:45:00 PM,11,Wednesday,34,6,12,27,79,normal
9:00:00 PM,11,Wednesday,40,9,5,20,74,normal
9:15:00 PM,11,Wednesday,64,19,22,12,117,normal
9:30:00 PM,11,Wednesday,108,24,34,7,173,heavy
9:45:00 PM,11,Wednesday,108,17,33,7,165,high
10:00:00 PM,11,Wednesday,50,23,21,11,105,normal
10:15:00 PM,11,Wednesday,16,21,10,16,63,normal
10:30:00 PM,11,Wednesday,91,22,34,8,155,high
10:45:00 PM,11,Wednesday,89,19,37,18,163,high
11:00:00 PM,11,Wednesday,108,12,23,8,151,normal
11:15:00 PM,11,Wednesday,73,29,23,7,132,normal
11:30:00 PM,11,Wednesday,76,28,39,14,157,high
11:45:00 PM,11,Wednesday,19,15,20,17,71,normal
12:00:00 AM,12,Thursday,102,37,48,9,196,heavy
12:15:00 AM,12,Thursday,115,36,41,8,200,heavy
12:30:00 AM,12,Thursday,142,23,23,6,194,heavy
12:45:00 AM,12,Thursday,134,15,29,8,186,heavy
1:00:00 AM,12,Thursday,146,18,49,9,222,heavy
1:15:00 AM,12,Thursday,126,24,48,9,207,heavy
1:30:00 AM,12,Thursday,138,18,27,6,189,heavy
1:45:00 AM,12,Thursday,129,13,43,6,191,heavy
2:00:00 AM,12,Thursday,127,35,23,10,195,heavy
2:15:00 AM,12,Thursday,144,20,22,7,193,heavy
2:30:00 AM,12,Thursday,117,19,31,7,174,heavy
2:45:00 AM,12,Thursday,87,10,13,16,126,normal
3:00:00 AM,12,Thursday,87,6,18,30,141,high
3:15:00 AM,12,Thursday,97,18,10,24,149,high
3:30:00 AM,12,Thursday,71,21,14,12,118,normal
3:45:00 AM,12,Thursday,96,24,18,10,148,normal
4:00:00 AM,12,Thursday,90,7,17,31,145,high
4:15:00 AM,12,Thursday,74,6,12,34,126,high
4:30:00 AM,12,Thursday,59,7,15,20,101,normal
4:45:00 AM,12,Thursday,87,11,16,28,142,high
5:00:00 AM,12,Thursday,62,22,20,20,124,normal
5:15:00 AM,12,Thursday,71,16,14,9,110,low
5:30:00 AM,12,Thursday,98,9,15,18,140,normal
5:45:00 AM,12,Thursday,93,8,10,16,127,normal
6:00:00 AM,12,Thursday,17,4,0,36,57,normal
6:15:00 AM,12,Thursday,16,1,1,29,47,normal
6:30:00 AM,12,Thursday,15,2,0,10,27,low
6:45:00 AM,12,Thursday,10,3,1,23,37,normal
7:00:00 AM,12,Thursday,12,4,0,31,47,normal
7:15:00 AM,12,Thursday,20,1,1,24,46,normal
7:30:00 AM,12,Thursday,11,0,1,23,35,normal
7:45:00 AM,12,Thursday,14,1,1,17,33,normal
8:00:00 AM,12,Thursday,12,5,1,38,56,normal
8:15:00 AM,12,Thursday,15,4,1,29,49,normal
8:30:00 AM,12,Thursday,12,4,0,40,56,normal
8:45:00 AM,12,Thursday,11,5,0,22,38,normal
9:00:00 AM,12,Thursday,14,5,1,21,41,normal
9:15:00 AM,12,Thursday,14,3,0,39,56,normal
9:30:00 AM,12,Thursday,10,4,1,11,26,low
9:45:00 AM,12,Thursday,11,0,0,16,27,normal
10:00:00 AM,12,Thursday,12,3,0,39,54,normal
10:15:00 AM,12,Thursday,11,0,1,36,48,normal
10:30:00 AM,12,Thursday,16,2,0,35,53,normal
10:45:00 AM,12,Thursday,17,3,1,36,57,normal
11:00:00 AM,12,Thursday,13,1,1,13,28,normal
11:15:00 AM,12,Thursday,14,5,0,19,38,normal
11:30:00 AM,12,Thursday,17,5,1,15,38,normal
11:45:00 AM,12,Thursday,19,3,0,13,35,normal
12:00:00 PM,12,Thursday,19,3,1,12,35,low
12:15:00 PM,12,Thursday,54,15,10,8,87,low
12:30:00 PM,12,Thursday,107,0,1,2,110,low
12:45:00 PM,12,Thursday,116,20,5,14,155,normal
1:00:00 PM,12,Thursday,78,2,4,9,93,low
1:15:00 PM,12,Thursday,111,22,0,12,145,normal
1:30:00 PM,12,Thursday,85,27,7,17,136,normal
1:45:00 PM,12,Thursday,95,5,9,20,129,normal
2:00:00 PM,12,Thursday,143,33,27,1,204,heavy
2:15:00 PM,12,Thursday,133,40,37,0,210,heavy
2:30:00 PM,12,Thursday,123,37,34,4,198,heavy
2:45:00 PM,12,Thursday,133,34,36,1,204,heavy
3:00:00 PM,12,Thursday,101,20,42,4,167,normal
3:15:00 PM,12,Thursday,145,10,37,0,192,heavy
3:30:00 PM,12,Thursday,141,39,40,5,225,heavy
3:45:00 PM,12,Thursday,134,12,22,2,170,heavy
4:00:00 PM,12,Thursday,126,10,26,4,166,high
4:15:00 PM,12,Thursday,136,22,31,0,189,heavy
4:30:00 PM,12,Thursday,128,26,42,4,200,heavy
4:45:00 PM,12,Thursday,106,12,28,4,150,high
5:00:00 PM,12,Thursday,140,27,36,2,205,heavy
5:15:00 PM,12,Thursday,40,20,37,28,125,high
5:30:00 PM,12,Thursday,13,25,33,12,83,normal
5:45:00 PM,12,Thursday,18,22,26,10,76,normal
6:00:00 PM,12,Thursday,59,5,36,12,112,high
6:15:00 PM,12,Thursday,48,9,30,14,101,normal
6:30:00 PM,12,Thursday,77,23,14,20,134,normal
6:45:00 PM,12,Thursday,17,13,13,27,70,normal
7:00:00 PM,12,Thursday,36,5,14,25,80,normal
7:15:00 PM,12,Thursday,60,10,3,28,101,normal
7:30:00 PM,12,Thursday,34,5,4,29,72,normal
7:45:00 PM,12,Thursday,63,5,6,20,94,normal
8:00:00 PM,12,Thursday,48,10,13,23,94,normal
8:15:00 PM,12,Thursday,44,5,5,21,75,normal
8:30:00 PM,12,Thursday,62,5,14,23,104,normal
8:45:00 PM,12,Thursday,38,8,15,27,88,normal
9:00:00 PM,12,Thursday,26,6,9,29,70,normal
9:15:00 PM,12,Thursday,78,23,16,13,130,normal
9:30:00 PM,12,Thursday,116,21,22,17,176,heavy
9:45:00 PM,12,Thursday,94,13,11,16,134,normal
10:00:00 PM,12,Thursday,52,19,26,10,107,normal
10:15:00 PM,12,Thursday,70,13,12,10,105,low
10:30:00 PM,12,Thursday,34,17,21,14,86,normal
10:45:00 PM,12,Thursday,16,18,40,6,80,normal
11:00:00 PM,12,Thursday,24,20,15,17,76,normal
11:15:00 PM,12,Thursday,21,15,33,12,81,normal
11:30:00 PM,12,Thursday,100,10,18,7,135,normal
11:45:00 PM,12,Thursday,117,22,11,5,155,normal
12:00:00 AM,13,Friday,145,30,40,8,223,normal
12:15:00 AM,13,Friday,113,38,45,7,203,heavy
12:30:00 AM,13,Friday,110,31,37,7,185,heavy
12:45:00 AM,13,Friday,126,15,26,6,173,heavy
1:00:00 AM,13,Friday,100,15,29,7,151,high
1:15:00 AM,13,Friday,147,28,29,10,214,heavy
1:30:00 AM,13,Friday,146,22,50,10,228,heavy
1:45:00 AM,13,Friday,148,23,27,5,203,heavy
2:00:00 AM,13,Friday,149,17,41,9,216,heavy
2:15:00 AM,13,Friday,136,32,41,7,216,heavy
2:30:00 AM,13,Friday,101,22,33,9,165,high
2:45:00 AM,13,Friday,87,18,13,34,152,high
3:00:00 AM,13,Friday,50,21,14,9,94,low
3:15:00 AM,13,Friday,63,23,19,34,139,high
3:30:00 AM,13,Friday,73,9,11,5,98,low
3:45:00 AM,13,Friday,78,13,20,25,136,high
4:00:00 AM,13,Friday,71,22,12,14,119,normal
4:15:00 AM,13,Friday,80,17,11,15,123,normal
4:30:00 AM,13,Friday,62,21,10,35,128,high
4:45:00 AM,13,Friday,100,17,16,33,166,high
5:00:00 AM,13,Friday,95,15,18,9,137,normal
5:15:00 AM,13,Friday,102,14,15,34,165,high
5:30:00 AM,13,Friday,68,12,15,32,127,high
5:45:00 AM,13,Friday,74,5,19,5,103,normal
6:00:00 AM,13,Friday,15,4,1,21,41,normal
6:15:00 AM,13,Friday,16,0,1,24,41,normal
6:30:00 AM,13,Friday,12,0,0,12,24,low
6:45:00 AM,13,Friday,12,5,0,23,40,normal
7:00:00 AM,13,Friday,15,2,1,14,32,normal
7:15:00 AM,13,Friday,10,3,0,23,36,normal
7:30:00 AM,13,Friday,16,2,0,35,53,normal
7:45:00 AM,13,Friday,13,3,0,22,38,normal
8:00:00 AM,13,Friday,13,0,0,32,45,normal
8:15:00 AM,13,Friday,11,1,0,27,39,normal
8:30:00 AM,13,Friday,17,1,0,32,50,normal
8:45:00 AM,13,Friday,11,2,0,17,30,normal
9:00:00 AM,13,Friday,14,1,1,11,27,low
9:15:00 AM,13,Friday,17,2,0,33,52,normal
9:30:00 AM,13,Friday,15,2,1,38,56,normal
9:45:00 AM,13,Friday,13,4,1,24,42,normal
10:00:00 AM,13,Friday,11,5,1,11,28,low
10:15:00 AM,13,Friday,12,3,0,22,37,normal
10:30:00 AM,13,Friday,15,1,0,26,42,normal
10:45:00 AM,13,Friday,13,0,1,34,48,normal
11:00:00 AM,13,Friday,17,5,0,15,37,normal
11:15:00 AM,13,Friday,20,3,1,26,50,normal
11:30:00 AM,13,Friday,18,4,0,30,52,normal
11:45:00 AM,13,Friday,12,1,1,19,33,normal
12:00:00 PM,13,Friday,20,0,0,12,32,low
12:15:00 PM,13,Friday,29,10,0,12,51,low
12:30:00 PM,13,Friday,39,20,1,10,70,low
12:45:00 PM,13,Friday,76,9,7,13,105,normal
1:00:00 PM,13,Friday,33,17,0,13,63,normal
1:15:00 PM,13,Friday,64,14,1,12,91,low
1:30:00 PM,13,Friday,44,7,1,11,63,low
1:45:00 PM,13,Friday,53,8,4,15,80,normal
2:00:00 PM,13,Friday,75,6,7,13,101,normal
2:15:00 PM,13,Friday,60,11,4,10,85,low
2:30:00 PM,13,Friday,35,14,2,14,65,normal
2:45:00 PM,13,Friday,75,20,6,15,116,normal
3:00:00 PM,13,Friday,27,10,2,12,51,low
3:15:00 PM,13,Friday,61,20,7,14,102,normal
3:30:00 PM,13,Friday,72,20,5,15,112,normal
3:45:00 PM,13,Friday,43,18,6,14,81,normal
4:00:00 PM,13,Friday,54,10,4,14,82,normal
4:15:00 PM,13,Friday,30,12,1,14,57,normal
4:30:00 PM,13,Friday,72,8,6,12,98,low
4:45:00 PM,13,Friday,55,17,7,15,94,normal
5:00:00 PM,13,Friday,36,20,0,13,69,normal
5:15:00 PM,13,Friday,168,55,10,0,233,heavy
5:30:00 PM,13,Friday,135,61,28,2,226,heavy
5:45:00 PM,13,Friday,168,68,27,2,265,heavy
6:00:00 PM,13,Friday,139,44,16,1,200,heavy
6:15:00 PM,13,Friday,156,63,12,3,234,heavy
6:30:00 PM,13,Friday,141,51,27,3,222,heavy
6:45:00 PM,13,Friday,144,44,16,3,207,heavy
7:00:00 PM,13,Friday,132,65,23,0,220,heavy
7:15:00 PM,13,Friday,180,48,17,2,247,heavy
7:30:00 PM,13,Friday,140,67,20,4,231,heavy
7:45:00 PM,13,Friday,163,62,12,0,237,heavy
8:00:00 PM,13,Friday,148,70,15,0,233,heavy
8:15:00 PM,13,Friday,134,47,22,3,206,heavy
8:30:00 PM,13,Friday,162,51,13,0,226,heavy
8:45:00 PM,13,Friday,136,49,15,1,201,heavy
9:00:00 PM,13,Friday,147,52,26,0,225,heavy
9:15:00 PM,13,Friday,174,54,25,1,254,heavy
9:30:00 PM,13,Friday,135,69,20,1,225,heavy
9:45:00 PM,13,Friday,142,55,21,1,219,heavy
10:00:00 PM,13,Friday,144,59,14,2,219,heavy
10:15:00 PM,13,Friday,180,49,17,0,246,heavy
10:30:00 PM,13,Friday,153,59,20,4,236,heavy
10:45:00 PM,13,Friday,139,43,27,3,212,heavy
11:00:00 PM,13,Friday,179,60,12,0,251,heavy
11:15:00 PM,13,Friday,76,21,6,1,104,low
11:30:00 PM,13,Friday,59,25,19,1,104,normal
11:45:00 PM,13,Friday,51,20,12,1,84,low
12:00:00 AM,14,Saturday,78,24,19,2,123,normal
12:15:00 AM,14,Saturday,50,24,11,0,85,low
12:30:00 AM,14,Saturday,59,25,8,0,92,low
12:45:00 AM,14,Saturday,90,21,0,0,111,low
1:00:00 AM,14,Saturday,79,26,21,2,128,normal
1:15:00 AM,14,Saturday,56,21,4,1,82,low
1:30:00 AM,14,Saturday,70,25,11,2,108,low
1:45:00 AM,14,Saturday,54,27,21,2,104,normal
2:00:00 AM,14,Saturday,53,22,13,2,90,low
2:15:00 AM,14,Saturday,59,27,5,2,93,low
2:30:00 AM,14,Saturday,63,30,21,0,114,normal
2:45:00 AM,14,Saturday,87,21,16,0,124,normal
3:00:00 AM,14,Saturday,71,26,19,1,117,normal
3:15:00 AM,14,Saturday,32,5,5,13,55,normal
3:30:00 AM,14,Saturday,36,6,7,2,51,low
3:45:00 AM,14,Saturday,35,10,0,2,47,low
4:00:00 AM,14,Saturday,40,10,5,10,65,low
4:15:00 AM,14,Saturday,44,6,1,3,54,low
4:30:00 AM,14,Saturday,40,6,1,3,50,low
4:45:00 AM,14,Saturday,45,2,7,7,61,low
5:00:00 AM,14,Saturday,44,2,6,5,57,low
5:15:00 AM,14,Saturday,33,4,4,5,46,low
5:30:00 AM,14,Saturday,22,5,3,13,43,normal
5:45:00 AM,14,Saturday,33,5,5,1,44,low
6:00:00 AM,14,Saturday,10,0,0,29,39,normal
6:15:00 AM,14,Saturday,19,3,1,35,58,normal
6:30:00 AM,14,Saturday,10,4,0,30,44,normal
6:45:00 AM,14,Saturday,12,3,1,25,41,normal
7:00:00 AM,14,Saturday,12,1,0,40,53,normal
7:15:00 AM,14,Saturday,20,2,0,19,41,normal
7:30:00 AM,14,Saturday,18,4,1,11,34,low
7:45:00 AM,14,Saturday,19,1,1,37,58,normal
8:00:00 AM,14,Saturday,13,2,0,25,40,normal
8:15:00 AM,14,Saturday,16,4,1,15,36,normal
8:30:00 AM,14,Saturday,10,4,1,16,31,normal
8:45:00 AM,14,Saturday,18,3,0,19,40,normal
9:00:00 AM,14,Saturday,15,5,0,10,30,low
9:15:00 AM,14,Saturday,14,2,1,22,39,normal
9:30:00 AM,14,Saturday,15,0,0,15,30,normal
9:45:00 AM,14,Saturday,17,5,0,21,43,normal
10:00:00 AM,14,Saturday,14,0,1,12,27,low
10:15:00 AM,14,Saturday,10,1,0,11,22,low
10:30:00 AM,14,Saturday,18,5,0,18,41,normal
10:45:00 AM,14,Saturday,12,4,0,11,27,low
11:00:00 AM,14,Saturday,17,0,1,30,48,normal
11:15:00 AM,14,Saturday,20,1,0,28,49,normal
11:30:00 AM,14,Saturday,19,5,1,38,63,normal
11:45:00 AM,14,Saturday,15,0,0,36,51,normal
12:00:00 PM,14,Saturday,10,2,0,30,42,normal
12:15:00 PM,14,Saturday,74,4,4,13,95,normal
12:30:00 PM,14,Saturday,96,29,6,17,148,normal
12:45:00 PM,14,Saturday,109,16,6,12,143,normal
1:00:00 PM,14,Saturday,113,6,9,10,138,normal
1:15:00 PM,14,Saturday,90,24,8,20,142,normal
1:30:00 PM,14,Saturday,106,19,10,17,152,normal
1:45:00 PM,14,Saturday,96,7,6,4,113,normal
2:00:00 PM,14,Saturday,102,21,42,3,168,heavy
2:15:00 PM,14,Saturday,140,35,50,0,225,heavy
2:30:00 PM,14,Saturday,105,33,29,4,171,heavy
2:45:00 PM,14,Saturday,134,26,27,1,188,heavy
3:00:00 PM,14,Saturday,123,35,45,1,204,heavy
3:15:00 PM,14,Saturday,128,31,26,0,185,heavy
3:30:00 PM,14,Saturday,105,32,43,0,180,heavy
3:45:00 PM,14,Saturday,137,13,31,5,186,heavy
4:00:00 PM,14,Saturday,148,37,46,2,233,heavy
4:15:00 PM,14,Saturday,105,14,35,2,156,high
4:30:00 PM,14,Saturday,148,17,42,5,212,heavy
4:45:00 PM,14,Saturday,116,22,30,3,171,heavy
5:00:00 PM,14,Saturday,143,28,46,1,218,heavy
5:15:00 PM,14,Saturday,30,24,13,13,80,normal
5:30:00 PM,14,Saturday,74,23,35,10,142,high
5:45:00 PM,14,Saturday,67,5,36,17,125,high
6:00:00 PM,14,Saturday,59,11,33,25,128,high
6:15:00 PM,14,Saturday,34,21,39,16,110,normal
6:30:00 PM,14,Saturday,72,24,10,9,115,normal
6:45:00 PM,14,Saturday,73,12,32,5,122,high
7:00:00 PM,14,Saturday,26,8,8,24,66,normal
7:15:00 PM,14,Saturday,47,5,7,28,87,normal
7:30:00 PM,14,Saturday,33,10,6,29,78,normal
7:45:00 PM,14,Saturday,39,8,13,20,80,normal
8:00:00 PM,14,Saturday,36,5,14,22,77,normal
8:15:00 PM,14,Saturday,53,9,15,25,102,normal
8:30:00 PM,14,Saturday,37,9,10,30,86,normal
8:45:00 PM,14,Saturday,54,8,4,27,93,normal
9:00:00 PM,14,Saturday,20,8,15,26,69,normal
9:15:00 PM,14,Saturday,47,29,28,9,113,high
9:30:00 PM,14,Saturday,51,27,10,20,108,normal
9:45:00 PM,14,Saturday,114,11,40,20,185,heavy
10:00:00 PM,14,Saturday,73,13,19,9,114,normal
10:15:00 PM,14,Saturday,28,19,27,5,79,normal
10:30:00 PM,14,Saturday,105,20,20,11,156,normal
10:45:00 PM,14,Saturday,68,24,15,14,121,normal
11:00:00 PM,14,Saturday,112,16,30,11,169,heavy
11:15:00 PM,14,Saturday,120,30,28,15,193,heavy
11:30:00 PM,14,Saturday,38,27,12,18,95,normal
11:45:00 PM,14,Saturday,94,17,14,15,140,normal
12:00:00 AM,15,Sunday,107,28,45,8,188,heavy
12:15:00 AM,15,Sunday,100,16,49,7,172,heavy
12:30:00 AM,15,Sunday,145,15,20,9,189,heavy
12:45:00 AM,15,Sunday,133,17,22,8,180,heavy
1:00:00 AM,15,Sunday,117,36,41,10,204,heavy
1:15:00 AM,15,Sunday,113,26,26,8,173,heavy
1:30:00 AM,15,Sunday,101,20,21,9,151,normal
1:45:00 AM,15,Sunday,149,33,45,10,237,heavy
2:00:00 AM,15,Sunday,134,35,26,7,202,heavy
2:15:00 AM,15,Sunday,106,11,45,9,171,heavy
2:30:00 AM,15,Sunday,121,37,34,6,198,heavy
2:45:00 AM,15,Sunday,97,13,11,15,136,normal
3:00:00 AM,15,Sunday,91,17,18,29,155,high
3:15:00 AM,15,Sunday,57,16,13,19,105,normal
3:30:00 AM,15,Sunday,110,10,10,20,150,normal
3:45:00 AM,15,Sunday,71,14,17,30,132,high
4:00:00 AM,15,Sunday,89,25,20,24,158,high
4:15:00 AM,15,Sunday,87,16,15,14,132,normal
4:30:00 AM,15,Sunday,106,12,16,9,143,normal
4:45:00 AM,15,Sunday,78,10,19,20,127,normal
5:00:00 AM,15,Sunday,61,10,16,27,114,high
5:15:00 AM,15,Sunday,74,19,15,24,132,high
5:30:00 AM,15,Sunday,56,20,11,25,112,high
5:45:00 AM,15,Sunday,106,22,16,18,162,normal
6:00:00 AM,15,Sunday,10,1,1,12,24,low
6:15:00 AM,15,Sunday,12,4,1,33,50,normal
6:30:00 AM,15,Sunday,16,4,0,16,36,normal
6:45:00 AM,15,Sunday,18,1,0,18,37,normal
7:00:00 AM,15,Sunday,19,2,0,36,57,normal
7:15:00 AM,15,Sunday,18,4,1,35,58,normal
7:30:00 AM,15,Sunday,17,0,0,31,48,normal
7:45:00 AM,15,Sunday,18,1,0,16,35,normal
8:00:00 AM,15,Sunday,15,4,0,37,56,normal
8:15:00 AM,15,Sunday,11,5,0,14,30,normal
8:30:00 AM,15,Sunday,11,5,0,22,38,normal
8:45:00 AM,15,Sunday,12,2,1,37,52,normal
9:00:00 AM,15,Sunday,18,1,1,34,54,normal
9:15:00 AM,15,Sunday,19,1,0,11,31,low
9:30:00 AM,15,Sunday,11,4,1,26,42,normal
9:45:00 AM,15,Sunday,18,3,0,28,49,normal
10:00:00 AM,15,Sunday,12,4,1,37,54,normal
10:15:00 AM,15,Sunday,11,1,1,29,42,normal
10:30:00 AM,15,Sunday,19,5,1,29,54,normal
10:45:00 AM,15,Sunday,18,4,0,11,33,low
11:00:00 AM,15,Sunday,16,4,0,29,49,normal
11:15:00 AM,15,Sunday,19,4,1,33,57,normal
11:30:00 AM,15,Sunday,15,3,1,12,31,low
11:45:00 AM,15,Sunday,16,4,1,28,49,normal
12:00:00 PM,15,Sunday,11,4,0,20,35,normal
12:15:00 PM,15,Sunday,93,4,1,16,114,normal
12:30:00 PM,15,Sunday,114,12,7,18,151,normal
12:45:00 PM,15,Sunday,56,7,5,20,88,normal
1:00:00 PM,15,Sunday,92,23,3,19,137,normal
1:15:00 PM,15,Sunday,99,6,6,7,118,normal
1:30:00 PM,15,Sunday,108,14,6,9,137,normal
1:45:00 PM,15,Sunday,66,20,2,16,104,normal
2:00:00 PM,15,Sunday,147,26,44,5,222,heavy
2:15:00 PM,15,Sunday,139,27,29,1,196,heavy
2:30:00 PM,15,Sunday,119,31,36,5,191,heavy
2:45:00 PM,15,Sunday,114,30,21,2,167,normal
3:00:00 PM,15,Sunday,103,27,21,4,155,normal
3:15:00 PM,15,Sunday,105,17,29,4,155,high
3:30:00 PM,15,Sunday,124,29,41,1,195,heavy
3:45:00 PM,15,Sunday,118,19,34,1,172,heavy
4:00:00 PM,15,Sunday,101,37,32,0,170,heavy
4:15:00 PM,15,Sunday,109,11,48,1,169,heavy
4:30:00 PM,15,Sunday,143,12,23,3,181,heavy
4:45:00 PM,15,Sunday,143,40,30,0,213,heavy
5:00:00 PM,15,Sunday,128,16,34,0,178,heavy
5:15:00 PM,15,Sunday,14,25,14,16,69,normal
5:30:00 PM,15,Sunday,99,10,11,15,135,normal
5:45:00 PM,15,Sunday,67,1,22,14,104,normal
6:00:00 PM,15,Sunday,42,2,29,9,82,normal
6:15:00 PM,15,Sunday,92,3,33,21,149,high
6:30:00 PM,15,Sunday,91,16,28,9,144,high
6:45:00 PM,15,Sunday,25,9,10,28,72,normal
7:00:00 PM,15,Sunday,37,5,12,29,83,normal
7:15:00 PM,15,Sunday,55,6,12,29,102,normal
7:30:00 PM,15,Sunday,49,8,8,26,91,normal
7:45:00 PM,15,Sunday,69,9,3,20,101,normal
8:00:00 PM,15,Sunday,38,6,6,24,74,normal
8:15:00 PM,15,Sunday,40,8,12,21,81,normal
8:30:00 PM,15,Sunday,53,5,3,20,81,normal
8:45:00 PM,15,Sunday,21,8,4,28,61,normal
9:00:00 PM,15,Sunday,24,7,4,20,55,normal
9:15:00 PM,15,Sunday,47,24,24,9,104,normal
9:30:00 PM,15,Sunday,90,30,32,8,160,high
9:45:00 PM,15,Sunday,120,21,22,14,177,heavy
10:00:00 PM,15,Sunday,120,12,40,13,185,heavy
10:15:00 PM,15,Sunday,66,14,21,7,108,normal
10:30:00 PM,15,Sunday,89,24,12,6,131,normal
10:45:00 PM,15,Sunday,80,17,16,5,118,normal
11:00:00 PM,15,Sunday,114,21,10,9,154,normal
11:15:00 PM,15,Sunday,94,20,7,10,131,normal
11:30:00 PM,15,Sunday,70,18,28,5,121,high
11:45:00 PM,15,Sunday,56,17,15,8,96,low
12:00:00 AM,16,Monday,141,15,20,6,182,heavy
12:15:00 AM,16,Monday,150,19,46,7,222,heavy
12:30:00 AM,16,Monday,119,37,22,8,186,heavy
12:45:00 AM,16,Monday,144,14,44,5,207,heavy
1:00:00 AM,16,Monday,110,25,46,6,187,heavy
1:15:00 AM,16,Monday,138,15,31,10,194,heavy
1:30:00 AM,16,Monday,140,35,41,5,221,heavy
1:45:00 AM,16,Monday,103,24,28,8,163,high
2:00:00 AM,16,Monday,142,27,30,5,204,heavy
2:15:00 AM,16,Monday,149,13,22,9,193,heavy
2:30:00 AM,16,Monday,126,40,39,8,213,heavy
2:45:00 AM,16,Monday,78,15,14,28,135,high
3:00:00 AM,16,Monday,102,15,11,29,157,high
3:15:00 AM,16,Monday,96,22,20,12,150,normal
3:30:00 AM,16,Monday,110,24,15,14,163,normal
3:45:00 AM,16,Monday,97,22,17,13,149,normal
4:00:00 AM,16,Monday,53,19,11,18,101,normal
4:15:00 AM,16,Monday,82,8,17,29,136,high
4:30:00 AM,16,Monday,91,24,18,29,162,high
4:45:00 AM,16,Monday,102,6,14,35,157,high
5:00:00 AM,16,Monday,109,6,15,18,148,normal
5:15:00 AM,16,Monday,78,16,13,27,134,high
5:30:00 AM,16,Monday,66,12,16,33,127,high
5:45:00 AM,16,Monday,100,17,15,22,154,high
6:00:00 AM,16,Monday,15,1,1,25,42,normal
6:15:00 AM,16,Monday,16,1,0,33,50,normal
6:30:00 AM,16,Monday,19,4,0,26,49,normal
6:45:00 AM,16,Monday,10,0,1,34,45,normal
7:00:00 AM,16,Monday,14,0,0,28,42,normal
7:15:00 AM,16,Monday,13,2,0,22,37,normal
7:30:00 AM,16,Monday,18,5,1,20,44,normal
7:45:00 AM,16,Monday,18,4,0,18,40,normal
8:00:00 AM,16,Monday,11,3,0,26,40,normal
8:15:00 AM,16,Monday,13,1,0,24,38,normal
8:30:00 AM,16,Monday,19,5,1,15,40,normal
8:45:00 AM,16,Monday,11,3,1,28,43,normal
9:00:00 AM,16,Monday,11,1,1,40,53,normal
9:15:00 AM,16,Monday,18,4,1,28,51,normal
9:30:00 AM,16,Monday,15,2,1,16,34,normal
9:45:00 AM,16,Monday,20,0,0,27,47,normal
10:00:00 AM,16,Monday,14,5,0,17,36,normal
10:15:00 AM,16,Monday,11,3,1,10,25,low
10:30:00 AM,16,Monday,18,5,0,22,45,normal
10:45:00 AM,16,Monday,12,4,0,16,32,normal
11:00:00 AM,16,Monday,10,2,0,24,36,normal
11:15:00 AM,16,Monday,20,0,1,36,57,normal
11:30:00 AM,16,Monday,20,1,0,29,50,normal
11:45:00 AM,16,Monday,16,4,0,24,44,normal
12:00:00 PM,16,Monday,18,3,0,22,43,normal
12:15:00 PM,16,Monday,88,11,10,3,112,normal
12:30:00 PM,16,Monday,114,5,9,7,135,normal
12:45:00 PM,16,Monday,103,3,9,17,132,normal
1:00:00 PM,16,Monday,81,16,7,14,118,normal
1:15:00 PM,16,Monday,94,1,9,3,107,low
1:30:00 PM,16,Monday,56,11,9,15,91,normal
1:45:00 PM,16,Monday,80,16,5,10,111,low
2:00:00 PM,16,Monday,138,35,47,4,224,heavy
2:15:00 PM,16,Monday,123,27,22,4,176,heavy
2:30:00 PM,16,Monday,114,30,36,2,182,heavy
2:45:00 PM,16,Monday,122,30,37,2,191,heavy
3:00:00 PM,16,Monday,148,10,28,2,188,heavy
3:15:00 PM,16,Monday,127,38,48,0,213,heavy
3:30:00 PM,16,Monday,113,32,44,1,190,heavy
3:45:00 PM,16,Monday,131,26,40,1,198,heavy
4:00:00 PM,16,Monday,108,27,44,5,184,heavy
4:15:00 PM,16,Monday,109,19,49,3,180,heavy
4:30:00 PM,16,Monday,125,15,28,3,171,heavy
4:45:00 PM,16,Monday,139,30,35,4,208,heavy
5:00:00 PM,16,Monday,103,35,50,2,190,heavy
5:15:00 PM,16,Monday,64,13,40,12,129,high
5:30:00 PM,16,Monday,79,1,10,30,120,high
5:45:00 PM,16,Monday,50,2,7,14,73,normal
6:00:00 PM,16,Monday,84,18,18,28,148,high
6:15:00 PM,16,Monday,99,16,39,26,180,heavy
6:30:00 PM,16,Monday,42,3,27,18,90,normal
6:45:00 PM,16,Monday,53,2,29,24,108,normal
7:00:00 PM,16,Monday,63,10,8,28,109,normal
7:15:00 PM,16,Monday,24,8,3,20,55,normal
7:30:00 PM,16,Monday,46,8,6,26,86,normal
7:45:00 PM,16,Monday,20,7,8,26,61,normal
8:00:00 PM,16,Monday,41,8,7,27,83,normal
8:15:00 PM,16,Monday,44,5,3,28,80,normal
8:30:00 PM,16,Monday,33,6,14,28,81,normal
8:45:00 PM,16,Monday,30,9,7,25,71,normal
9:00:00 PM,16,Monday,68,7,5,25,105,normal
9:15:00 PM,16,Monday,28,29,26,5,88,normal
9:30:00 PM,16,Monday,96,20,14,18,148,normal
9:45:00 PM,16,Monday,24,15,26,13,78,normal
10:00:00 PM,16,Monday,70,21,32,18,141,high
10:15:00 PM,16,Monday,49,21,11,20,101,normal
10:30:00 PM,16,Monday,51,22,12,16,101,normal
10:45:00 PM,16,Monday,84,12,15,15,126,normal
11:00:00 PM,16,Monday,99,18,7,20,144,normal
11:15:00 PM,16,Monday,106,10,9,8,133,normal
11:30:00 PM,16,Monday,6,11,34,20,71,normal
11:45:00 PM,16,Monday,59,29,15,16,119,normal
12:00:00 AM,17,Tuesday,139,25,41,5,210,heavy
12:15:00 AM,17,Tuesday,109,12,49,6,176,heavy
12:30:00 AM,17,Tuesday,124,24,47,9,204,heavy
12:45:00 AM,17,Tuesday,135,29,39,7,210,heavy
1:00:00 AM,17,Tuesday,137,15,37,7,196,heavy
1:15:00 AM,17,Tuesday,119,28,46,9,202,heavy
1:30:00 AM,17,Tuesday,127,21,28,5,181,heavy
1:45:00 AM,17,Tuesday,109,37,44,9,199,heavy
2:00:00 AM,17,Tuesday,145,27,35,7,214,heavy
2:15:00 AM,17,Tuesday,133,36,28,6,203,heavy
2:30:00 AM,17,Tuesday,138,19,36,5,198,heavy
2:45:00 AM,17,Tuesday,73,5,20,10,108,normal
3:00:00 AM,17,Tuesday,83,11,14,33,141,high
3:15:00 AM,17,Tuesday,89,8,10,19,126,normal
3:30:00 AM,17,Tuesday,99,19,18,24,160,high
3:45:00 AM,17,Tuesday,54,17,14,8,93,low
4:00:00 AM,17,Tuesday,58,18,14,6,96,low
4:15:00 AM,17,Tuesday,56,16,12,9,93,low
4:30:00 AM,17,Tuesday,77,6,20,5,108,normal
4:45:00 AM,17,Tuesday,85,6,18,17,126,normal
5:00:00 AM,17,Tuesday,105,14,13,32,164,high
5:15:00 AM,17,Tuesday,96,21,11,24,152,high
5:30:00 AM,17,Tuesday,66,22,17,16,121,normal
5:45:00 AM,17,Tuesday,88,15,19,14,136,normal
6:00:00 AM,17,Tuesday,16,1,1,24,42,normal
6:15:00 AM,17,Tuesday,13,1,0,11,25,low
6:30:00 AM,17,Tuesday,13,5,1,23,42,normal
6:45:00 AM,17,Tuesday,19,5,0,37,61,normal
7:00:00 AM,17,Tuesday,19,1,0,31,51,normal
7:15:00 AM,17,Tuesday,11,5,0,19,35,normal
7:30:00 AM,17,Tuesday,18,3,0,32,53,normal
7:45:00 AM,17,Tuesday,17,1,1,38,57,normal
8:00:00 AM,17,Tuesday,17,3,0,20,40,normal
8:15:00 AM,17,Tuesday,18,4,1,19,42,normal
8:30:00 AM,17,Tuesday,19,3,0,24,46,normal
8:45:00 AM,17,Tuesday,16,3,0,15,34,normal
9:00:00 AM,17,Tuesday,12,5,1,21,39,normal
9:15:00 AM,17,Tuesday,17,3,0,36,56,normal
9:30:00 AM,17,Tuesday,19,4,1,21,45,normal
9:45:00 AM,17,Tuesday,13,5,0,20,38,normal
10:00:00 AM,17,Tuesday,14,0,1,37,52,normal
10:15:00 AM,17,Tuesday,14,5,0,39,58,normal
10:30:00 AM,17,Tuesday,13,1,0,19,33,normal
10:45:00 AM,17,Tuesday,18,5,1,25,49,normal
11:00:00 AM,17,Tuesday,15,1,1,15,32,normal
11:15:00 AM,17,Tuesday,19,2,0,30,51,normal
11:30:00 AM,17,Tuesday,18,2,1,27,48,normal
11:45:00 AM,17,Tuesday,13,1,0,38,52,normal
12:00:00 PM,17,Tuesday,19,2,0,32,53,normal
12:15:00 PM,17,Tuesday,116,0,1,9,126,normal
12:30:00 PM,17,Tuesday,60,12,8,15,95,normal
12:45:00 PM,17,Tuesday,82,15,0,19,116,normal
1:00:00 PM,17,Tuesday,67,23,7,3,100,low
1:15:00 PM,17,Tuesday,59,27,10,18,114,normal
1:30:00 PM,17,Tuesday,66,6,9,5,86,low
1:45:00 PM,17,Tuesday,120,10,3,16,149,normal
2:00:00 PM,17,Tuesday,121,22,30,0,173,heavy
2:15:00 PM,17,Tuesday,130,27,39,5,201,heavy
2:30:00 PM,17,Tuesday,139,31,44,3,217,heavy
2:45:00 PM,17,Tuesday,129,14,43,5,191,heavy
3:00:00 PM,17,Tuesday,131,28,43,5,207,heavy
3:15:00 PM,17,Tuesday,119,39,24,1,183,heavy
3:30:00 PM,17,Tuesday,142,25,34,5,206,heavy
3:45:00 PM,17,Tuesday,123,22,22,3,170,heavy
4:00:00 PM,17,Tuesday,106,19,38,4,167,normal
4:15:00 PM,17,Tuesday,115,39,20,2,176,heavy
4:30:00 PM,17,Tuesday,111,17,32,1,161,high
4:45:00 PM,17,Tuesday,144,26,50,3,223,normal
5:00:00 PM,17,Tuesday,126,31,48,2,207,heavy
5:15:00 PM,17,Tuesday,73,22,21,29,145,high
5:30:00 PM,17,Tuesday,28,7,25,18,78,normal
5:45:00 PM,17,Tuesday,31,10,40,9,90,normal
6:00:00 PM,17,Tuesday,51,14,33,14,112,high
6:15:00 PM,17,Tuesday,22,7,39,23,91,normal
6:30:00 PM,17,Tuesday,46,5,11,21,83,normal
6:45:00 PM,17,Tuesday,72,22,21,27,142,high
7:00:00 PM,17,Tuesday,70,5,5,29,109,normal
7:15:00 PM,17,Tuesday,28,9,9,24,70,normal
7:30:00 PM,17,Tuesday,44,5,11,23,83,normal
7:45:00 PM,17,Tuesday,27,6,13,30,76,normal
8:00:00 PM,17,Tuesday,20,6,6,23,55,normal
8:15:00 PM,17,Tuesday,29,7,3,28,67,normal
8:30:00 PM,17,Tuesday,20,6,5,27,58,normal
8:45:00 PM,17,Tuesday,65,9,15,22,111,normal
9:00:00 PM,17,Tuesday,36,5,6,20,67,normal
9:15:00 PM,17,Tuesday,99,21,21,6,147,normal
9:30:00 PM,17,Tuesday,101,21,34,18,174,heavy
9:45:00 PM,17,Tuesday,98,29,34,12,173,heavy
10:00:00 PM,17,Tuesday,113,20,7,13,153,normal
10:15:00 PM,17,Tuesday,75,24,27,7,133,high
10:30:00 PM,17,Tuesday,71,21,38,11,141,high
10:45:00 PM,17,Tuesday,119,13,32,7,171,heavy
11:00:00 PM,17,Tuesday,114,11,39,13,177,heavy
11:15:00 PM,17,Tuesday,99,26,8,11,144,normal
11:30:00 PM,17,Tuesday,39,12,21,9,81,normal
11:45:00 PM,17,Tuesday,114,26,16,20,176,heavy
12:00:00 AM,18,Wednesday,120,32,39,9,200,heavy
12:15:00 AM,18,Wednesday,143,24,35,6,208,heavy
12:30:00 AM,18,Wednesday,121,28,21,5,175,heavy
12:45:00 AM,18,Wednesday,134,23,28,10,195,heavy
1:00:00 AM,18,Wednesday,103,13,37,10,163,high
1:15:00 AM,18,Wednesday,122,12,48,10,192,heavy
1:30:00 AM,18,Wednesday,145,39,23,6,213,heavy
1:45:00 AM,18,Wednesday,105,13,48,10,176,heavy
2:00:00 AM,18,Wednesday,144,13,40,10,207,heavy
2:15:00 AM,18,Wednesday,103,18,40,5,166,high
2:30:00 AM,18,Wednesday,120,15,34,8,177,heavy
2:45:00 AM,18,Wednesday,56,19,16,13,104,normal
3:00:00 AM,18,Wednesday,56,5,17,14,92,normal
3:15:00 AM,18,Wednesday,108,15,13,5,141,normal
3:30:00 AM,18,Wednesday,58,23,14,34,129,high
3:45:00 AM,18,Wednesday,58,13,11,33,115,high
4:00:00 AM,18,Wednesday,76,24,14,15,129,normal
4:15:00 AM,18,Wednesday,69,8,13,28,118,high
4:30:00 AM,18,Wednesday,54,9,12,10,85,low
4:45:00 AM,18,Wednesday,89,7,10,10,116,normal
5:00:00 AM,18,Wednesday,110,18,18,10,156,normal
5:15:00 AM,18,Wednesday,86,12,17,18,133,normal
5:30:00 AM,18,Wednesday,82,7,16,9,114,normal
5:45:00 AM,18,Wednesday,102,5,19,11,137,normal
6:00:00 AM,18,Wednesday,16,5,0,21,42,normal
6:15:00 AM,18,Wednesday,11,3,1,39,54,normal
6:30:00 AM,18,Wednesday,18,5,0,11,34,low
6:45:00 AM,18,Wednesday,12,0,1,32,45,normal
7:00:00 AM,18,Wednesday,15,4,1,39,59,normal
7:15:00 AM,18,Wednesday,15,4,0,26,45,normal
7:30:00 AM,18,Wednesday,13,1,0,30,44,normal
7:45:00 AM,18,Wednesday,12,3,0,28,43,normal
8:00:00 AM,18,Wednesday,17,2,1,20,40,normal
8:15:00 AM,18,Wednesday,14,5,1,33,53,normal
8:30:00 AM,18,Wednesday,16,3,1,11,31,low
8:45:00 AM,18,Wednesday,18,2,1,13,34,normal
9:00:00 AM,18,Wednesday,12,2,1,17,32,normal
9:15:00 AM,18,Wednesday,17,4,1,15,37,normal
9:30:00 AM,18,Wednesday,18,1,1,25,45,normal
9:45:00 AM,18,Wednesday,20,1,1,10,32,low
10:00:00 AM,18,Wednesday,15,1,0,21,37,normal
10:15:00 AM,18,Wednesday,11,3,1,34,49,normal
10:30:00 AM,18,Wednesday,19,0,1,13,33,normal
10:45:00 AM,18,Wednesday,10,3,0,14,27,normal
11:00:00 AM,18,Wednesday,17,5,1,17,40,normal
11:15:00 AM,18,Wednesday,16,1,0,11,28,low
11:30:00 AM,18,Wednesday,11,0,1,33,45,normal
11:45:00 AM,18,Wednesday,10,5,0,39,54,normal
12:00:00 PM,18,Wednesday,12,3,0,32,47,normal
12:15:00 PM,18,Wednesday,106,16,10,10,142,normal
12:30:00 PM,18,Wednesday,69,18,0,12,99,low
12:45:00 PM,18,Wednesday,103,26,6,12,147,normal
1:00:00 PM,18,Wednesday,99,25,6,6,136,normal
1:15:00 PM,18,Wednesday,85,9,4,11,109,low
1:30:00 PM,18,Wednesday,109,0,3,8,120,normal
1:45:00 PM,18,Wednesday,106,27,1,6,140,normal
2:00:00 PM,18,Wednesday,133,28,31,3,195,heavy
2:15:00 PM,18,Wednesday,108,39,34,5,186,heavy
2:30:00 PM,18,Wednesday,101,12,48,1,162,high
2:45:00 PM,18,Wednesday,145,11,29,1,186,heavy
3:00:00 PM,18,Wednesday,112,33,29,3,177,heavy
3:15:00 PM,18,Wednesday,111,18,32,4,165,high
3:30:00 PM,18,Wednesday,133,39,44,2,218,heavy
3:45:00 PM,18,Wednesday,115,34,37,5,191,heavy
4:00:00 PM,18,Wednesday,135,35,38,3,211,heavy
4:15:00 PM,18,Wednesday,142,40,28,3,213,heavy
4:30:00 PM,18,Wednesday,124,11,27,2,164,high
4:45:00 PM,18,Wednesday,122,29,31,5,187,heavy
5:00:00 PM,18,Wednesday,101,19,23,5,148,normal
5:15:00 PM,18,Wednesday,72,5,15,20,112,normal
5:30:00 PM,18,Wednesday,100,13,23,9,145,normal
5:45:00 PM,18,Wednesday,32,10,33,8,83,normal
6:00:00 PM,18,Wednesday,42,25,37,12,116,high
6:15:00 PM,18,Wednesday,81,25,40,20,166,high
6:30:00 PM,18,Wednesday,56,18,9,23,106,normal
6:45:00 PM,18,Wednesday,84,9,31,17,141,high
7:00:00 PM,18,Wednesday,36,9,8,28,81,normal
7:15:00 PM,18,Wednesday,32,5,11,27,75,normal
7:30:00 PM,18,Wednesday,26,7,15,27,75,normal
7:45:00 PM,18,Wednesday,34,5,5,22,66,normal
8:00:00 PM,18,Wednesday,66,9,6,30,111,normal
8:15:00 PM,18,Wednesday,69,10,4,24,107,normal
8:30:00 PM,18,Wednesday,44,7,9,20,80,normal
8:45:00 PM,18,Wednesday,58,10,5,27,100,normal
9:00:00 PM,18,Wednesday,27,6,14,30,77,normal
9:15:00 PM,18,Wednesday,19,21,25,15,80,normal
9:30:00 PM,18,Wednesday,39,15,30,8,92,normal
9:45:00 PM,18,Wednesday,109,21,10,12,152,normal
10:00:00 PM,18,Wednesday,93,10,9,15,127,normal
10:15:00 PM,18,Wednesday,73,16,12,11,112,normal
10:30:00 PM,18,Wednesday,111,18,29,16,174,heavy
10:45:00 PM,18,Wednesday,37,20,10,19,86,normal
11:00:00 PM,18,Wednesday,74,23,13,20,130,normal
11:15:00 PM,18,Wednesday,32,28,35,6,101,normal
11:30:00 PM,18,Wednesday,34,23,19,17,93,normal
11:45:00 PM,18,Wednesday,59,25,9,20,113,normal
12:00:00 AM,19,Thursday,145,12,24,8,189,heavy
12:15:00 AM,19,Thursday,118,17,28,8,171,heavy
12:30:00 AM,19,Thursday,145,20,47,8,220,heavy
12:45:00 AM,19,Thursday,140,25,46,10,221,heavy
1:00:00 AM,19,Thursday,120,35,43,7,205,heavy
1:15:00 AM,19,Thursday,126,24,31,7,188,heavy
1:30:00 AM,19,Thursday,106,22,43,5,176,heavy
1:45:00 AM,19,Thursday,137,40,28,9,214,heavy
2:00:00 AM,19,Thursday,108,40,25,6,179,heavy
2:15:00 AM,19,Thursday,135,15,50,6,206,heavy
2:30:00 AM,19,Thursday,121,21,49,8,199,heavy
2:45:00 AM,19,Thursday,59,6,20,6,91,normal
3:00:00 AM,19,Thursday,59,13,18,27,117,high
3:15:00 AM,19,Thursday,103,7,15,15,140,normal
3:30:00 AM,19,Thursday,56,14,14,31,115,high
3:45:00 AM,19,Thursday,106,23,12,9,150,normal
4:00:00 AM,19,Thursday,109,5,16,17,147,normal
4:15:00 AM,19,Thursday,110,5,20,11,146,normal
4:30:00 AM,19,Thursday,86,15,15,23,139,high
4:45:00 AM,19,Thursday,91,18,19,26,154,high
5:00:00 AM,19,Thursday,99,19,15,28,161,high
5:15:00 AM,19,Thursday,93,14,20,17,144,normal
5:30:00 AM,19,Thursday,89,25,13,23,150,high
5:45:00 AM,19,Thursday,107,15,12,24,158,high
6:00:00 AM,19,Thursday,16,5,0,14,35,normal
6:15:00 AM,19,Thursday,14,5,1,20,40,normal
6:30:00 AM,19,Thursday,18,3,0,24,45,normal
6:45:00 AM,19,Thursday,12,3,0,40,55,normal
7:00:00 AM,19,Thursday,14,4,1,27,46,normal
7:15:00 AM,19,Thursday,18,5,1,15,39,normal
7:30:00 AM,19,Thursday,10,4,1,23,38,normal
7:45:00 AM,19,Thursday,10,5,0,14,29,normal
8:00:00 AM,19,Thursday,14,3,0,28,45,normal
8:15:00 AM,19,Thursday,10,2,0,38,50,normal
8:30:00 AM,19,Thursday,19,0,0,32,51,normal
8:45:00 AM,19,Thursday,20,3,0,19,42,normal
9:00:00 AM,19,Thursday,18,3,0,14,35,normal
9:15:00 AM,19,Thursday,11,2,0,12,25,low
9:30:00 AM,19,Thursday,17,1,1,13,32,normal
9:45:00 AM,19,Thursday,10,0,1,36,47,normal
10:00:00 AM,19,Thursday,17,0,0,32,49,normal
10:15:00 AM,19,Thursday,20,5,1,22,48,normal
10:30:00 AM,19,Thursday,12,3,0,17,32,normal
10:45:00 AM,19,Thursday,13,0,0,31,44,normal
11:00:00 AM,19,Thursday,11,1,1,35,48,normal
11:15:00 AM,19,Thursday,18,2,0,19,39,normal
11:30:00 AM,19,Thursday,15,0,1,24,40,normal
11:45:00 AM,19,Thursday,14,3,0,25,42,normal
12:00:00 PM,19,Thursday,12,0,1,16,29,normal
12:15:00 PM,19,Thursday,85,24,5,5,119,normal
12:30:00 PM,19,Thursday,71,22,5,2,100,low
12:45:00 PM,19,Thursday,108,4,5,3,120,normal
1:00:00 PM,19,Thursday,63,29,5,15,112,normal
1:15:00 PM,19,Thursday,62,12,3,18,95,normal
1:30:00 PM,19,Thursday,118,15,3,11,147,normal
1:45:00 PM,19,Thursday,90,21,2,14,127,normal
2:00:00 PM,19,Thursday,141,30,31,1,203,heavy
2:15:00 PM,19,Thursday,126,31,33,2,192,heavy
2:30:00 PM,19,Thursday,112,26,30,4,172,heavy
2:45:00 PM,19,Thursday,112,12,38,4,166,high
3:00:00 PM,19,Thursday,144,14,33,4,195,heavy
3:15:00 PM,19,Thursday,127,13,36,1,177,heavy
3:30:00 PM,19,Thursday,146,10,44,5,205,heavy
3:45:00 PM,19,Thursday,146,22,26,4,198,heavy
4:00:00 PM,19,Thursday,101,10,48,5,164,high
4:15:00 PM,19,Thursday,104,19,24,4,151,normal
4:30:00 PM,19,Thursday,150,20,43,0,213,heavy
4:45:00 PM,19,Thursday,110,35,45,2,192,heavy
5:00:00 PM,19,Thursday,139,15,28,2,184,heavy
5:15:00 PM,19,Thursday,99,17,32,7,155,high
5:30:00 PM,19,Thursday,22,15,7,19,63,normal
5:45:00 PM,19,Thursday,11,12,21,24,68,normal
6:00:00 PM,19,Thursday,47,20,18,16,101,normal
6:15:00 PM,19,Thursday,54,1,35,26,116,high
6:30:00 PM,19,Thursday,26,16,13,16,71,normal
6:45:00 PM,19,Thursday,99,18,39,19,175,heavy
7:00:00 PM,19,Thursday,31,9,11,28,79,normal
7:15:00 PM,19,Thursday,24,8,13,23,68,normal
7:30:00 PM,19,Thursday,21,7,9,20,57,normal
7:45:00 PM,19,Thursday,60,10,5,25,100,normal
8:00:00 PM,19,Thursday,29,9,12,21,71,normal
8:15:00 PM,19,Thursday,37,7,14,28,86,normal
8:30:00 PM,19,Thursday,53,7,11,22,93,normal
8:45:00 PM,19,Thursday,35,5,15,25,80,normal
9:00:00 PM,19,Thursday,53,6,10,28,97,normal
9:15:00 PM,19,Thursday,114,18,17,8,157,normal
9:30:00 PM,19,Thursday,95,28,22,9,154,normal
9:45:00 PM,19,Thursday,62,23,38,19,142,high
10:00:00 PM,19,Thursday,70,28,12,12,122,normal
10:15:00 PM,19,Thursday,35,20,10,8,73,low
10:30:00 PM,19,Thursday,60,23,10,20,113,normal
10:45:00 PM,19,Thursday,40,22,25,9,96,normal
11:00:00 PM,19,Thursday,53,21,6,11,91,low
11:15:00 PM,19,Thursday,99,16,38,7,160,high
11:30:00 PM,19,Thursday,86,21,31,18,156,high
11:45:00 PM,19,Thursday,79,28,35,13,155,high
12:00:00 AM,20,Friday,146,25,33,8,212,heavy
12:15:00 AM,20,Friday,116,24,36,6,182,heavy
12:30:00 AM,20,Friday,107,14,44,5,170,heavy
12:45:00 AM,20,Friday,115,20,27,9,171,heavy
1:00:00 AM,20,Friday,113,23,43,6,185,heavy
1:15:00 AM,20,Friday,102,20,31,5,158,high
1:30:00 AM,20,Friday,138,27,21,7,193,heavy
1:45:00 AM,20,Friday,146,13,38,9,206,heavy
2:00:00 AM,20,Friday,139,33,41,7,220,heavy
2:15:00 AM,20,Friday,130,24,48,9,211,heavy
2:30:00 AM,20,Friday,135,31,34,8,208,heavy
2:45:00 AM,20,Friday,106,22,16,20,164,normal
3:00:00 AM,20,Friday,109,23,14,26,172,heavy
3:15:00 AM,20,Friday,108,24,19,10,161,normal
3:30:00 AM,20,Friday,50,16,16,11,93,normal
3:45:00 AM,20,Friday,102,22,17,10,151,normal
4:00:00 AM,20,Friday,72,25,10,27,134,high
4:15:00 AM,20,Friday,91,13,18,13,135,normal
4:30:00 AM,20,Friday,67,19,11,8,105,low
4:45:00 AM,20,Friday,61,14,10,5,90,low
5:00:00 AM,20,Friday,107,13,14,28,162,high
5:15:00 AM,20,Friday,91,5,12,34,142,high
5:30:00 AM,20,Friday,106,18,13,27,164,high
5:45:00 AM,20,Friday,107,14,10,18,149,normal
6:00:00 AM,20,Friday,17,4,1,20,42,normal
6:15:00 AM,20,Friday,11,4,1,30,46,normal
6:30:00 AM,20,Friday,11,4,0,23,38,normal
6:45:00 AM,20,Friday,16,3,1,36,56,normal
7:00:00 AM,20,Friday,11,0,1,30,42,normal
7:15:00 AM,20,Friday,15,4,1,25,45,normal
7:30:00 AM,20,Friday,16,5,0,27,48,normal
7:45:00 AM,20,Friday,14,3,1,15,33,normal
