Time,Date,Day of the week,CarCount,BikeCount,BusCount,TruckCount,Total,Traffic Situation
12:00:00 AM,10,Tuesday,54,18,3,12,87,low
12:15:00 AM,10,Tuesday,69,8,0,14,91,normal
12:30:00 AM,10,Tuesday,52,19,6,10,87,low
12:45:00 AM,10,Tuesday,66,8,0,12,86,low
1:00:00 AM,10,Tuesday,54,11,0,13,78,normal
1:15:00 AM,10,Tuesday,151,48,15,3,217,heavy
1:30:00 AM,10,Tuesday,170,62,18,2,252,heavy
1:45:00 AM,10,Tuesday,134,59,11,3,207,heavy
2:00:00 AM,10,Tuesday,166,63,22,1,252,heavy
2:15:00 AM,10,Tuesday,173,64,10,2,249,heavy
2:30:00 AM,10,Tuesday,176,45,22,2,245,heavy
2:45:00 AM,10,Tuesday,162,59,27,1,249,heavy
3:00:00 AM,10,Tuesday,171,46,15,3,235,heavy
3:15:00 AM,10,Tuesday,158,44,26,2,230,heavy
3:30:00 AM,10,Tuesday,151,64,16,0,231,heavy
3:45:00 AM,10,Tuesday,162,65,14,3,244,heavy
4:00:00 AM,10,Tuesday,179,44,23,1,247,heavy
4:15:00 AM,10,Tuesday,175,59,11,3,248,heavy
4:30:00 AM,10,Tuesday,173,63,13,2,251,heavy
4:45:00 AM,10,Tuesday,144,66,11,3,224,heavy
5:00:00 AM,10,Tuesday,132,68,22,4,226,heavy
5:15:00 AM,10,Tuesday,161,50,10,0,221,heavy
5:30:00 AM,10,Tuesday,151,56,29,1,237,heavy
5:45:00 AM,10,Tuesday,168,59,24,1,252,heavy
6:00:00 AM,10,Tuesday,144,65,20,3,232,heavy
6:15:00 AM,10,Tuesday,179,63,12,2,256,heavy
6:30:00 AM,10,Tuesday,161,56,12,4,233,heavy
6:45:00 AM,10,Tuesday,134,67,12,1,214,heavy
7:00:00 AM,10,Tuesday,140,70,23,4,237,heavy
7:15:00 AM,10,Tuesday,66,29,24,1,120,normal
7:30:00 AM,10,Tuesday,60,27,17,2,106,normal
7:45:00 AM,10,Tuesday,89,27,10,2,128,normal
8:00:00 AM,10,Tuesday,81,29,5,0,115,normal
8:15:00 AM,10,Tuesday,78,22,12,1,113,normal
8:30:00 AM,10,Tuesday,71,24,18,2,115,normal
8:45:00 AM,10,Tuesday,50,26,9,1,86,low
9:00:00 AM,10,Tuesday,55,28,5,0,88,low
9:15:00 AM,10,Tuesday,61,20,25,1,107,normal
9:30:00 AM,10,Tuesday,76,22,14,2,114,normal
9:45:00 AM,10,Tuesday,50,20,23,1,94,normal
10:00:00 AM,10,Tuesday,89,26,0,2,117,normal
10:15:00 AM,10,Tuesday,62,20,17,0,99,normal
10:30:00 AM,10,Tuesday,83,20,23,2,128,normal
10:45:00 AM,10,Tuesday,65,20,2,0,87,low
11:00:00 AM,10,Tuesday,60,21,2,1,84,low
11:15:00 AM,10,Tuesday,36,8,3,9,56,low
11:30:00 AM,10,Tuesday,39,5,4,11,59,low
11:45:00 AM,10,Tuesday,26,8,3,0,37,low
12:00:00 PM,10,Tuesday,23,4,0,5,32,low
12:15:00 PM,10,Tuesday,50,2,0,4,56,low
12:30:00 PM,10,Tuesday,30,2,3,1,36,low
12:45:00 PM,10,Tuesday,48,10,4,2,64,low
1:00:00 PM,10,Tuesday,39,6,6,1,52,low
1:15:00 PM,10,Tuesday,47,10,3,9,69,low
1:30:00 PM,10,Tuesday,26,3,5,3,37,low
1:45:00 PM,10,Tuesday,25,6,3,9,43,low
2:00:00 PM,10,Tuesday,19,1,0,11,31,low
2:15:00 PM,10,Tuesday,16,5,0,26,47,normal
2:30:00 PM,10,Tuesday,15,2,1,39,57,normal
2:45:00 PM,10,Tuesday,14,5,0,11,30,low
3:00:00 PM,10,Tuesday,12,2,0,20,34,normal
3:15:00 PM,10,Tuesday,11,2,0,35,48,normal
3:30:00 PM,10,Tuesday,18,5,1,11,35,low
3:45:00 PM,10,Tuesday,17,2,0,20,39,normal
4:00:00 PM,10,Tuesday,19,5,1,30,55,normal
4:15:00 PM,10,Tuesday,17,4,1,24,46,normal
4:30:00 PM,10,Tuesday,16,3,0,14,33,normal
4:45:00 PM,10,Tuesday,16,3,1,23,43,normal
5:00:00 PM,10,Tuesday,20,0,1,17,38,normal
5:15:00 PM,10,Tuesday,20,0,0,37,57,normal
5:30:00 PM,10,Tuesday,18,0,1,30,49,normal
5:45:00 PM,10,Tuesday,19,1,0,14,34,normal
6:00:00 PM,10,Tuesday,18,5,0,29,52,normal
6:15:00 PM,10,Tuesday,11,1,0,22,34,normal
6:30:00 PM,10,Tuesday,20,3,0,24,47,normal
6:45:00 PM,10,Tuesday,12,2,1,10,25,low
7:00:00 PM,10,Tuesday,19,5,1,31,56,normal
7:15:00 PM,10,Tuesday,10,0,0,32,42,normal
7:30:00 PM,10,Tuesday,14,1,1,12,28,low
7:45:00 PM,10,Tuesday,14,2,1,24,41,normal
8:00:00 PM,10,Tuesday,10,3,0,32,45,normal
8:15:00 PM,10,Tuesday,97,23,6,17,143,normal
8:30:00 PM,10,Tuesday,104,22,7,11,144,normal
8:45:00 PM,10,Tuesday,100,15,8,20,143,normal
9:00:00 PM,10,Tuesday,87,7,7,4,105,low
9:15:00 PM,10,Tuesday,77,27,8,10,122,normal
9:30:00 PM,10,Tuesday,51,7,4,5,67,low
9:45:00 PM,10,Tuesday,79,1,10,6,96,low
10:00:00 PM,10,Tuesday,100,40,29,5,174,heavy
10:15:00 PM,10,Tuesday,112,13,39,0,164,high
10:30:00 PM,10,Tuesday,120,16,34,2,172,heavy
10:45:00 PM,10,Tuesday,123,14,26,3,166,high
11:00:00 PM,10,Tuesday,142,27,27,4,200,heavy
11:15:00 PM,10,Tuesday,139,38,49,2,228,heavy
11:30:00 PM,10,Tuesday,134,24,21,2,181,heavy
11:45:00 PM,10,Tuesday,102,13,31,0,146,high
12:00:00 AM,11,Wednesday,102,16,43,4,165,high
12:15:00 AM,11,Wednesday,106,16,32,1,155,high
12:30:00 AM,11,Wednesday,117,19,42,3,181,heavy
12:45:00 AM,11,Wednesday,139,36,40,3,218,heavy
1:00:00 AM,11,Wednesday,121,13,25,2,161,normal
1:15:00 AM,11,Wednesday,65,19,16,11,111,normal
1:30:00 AM,11,Wednesday,12,25,39,28,104,normal
1:45:00 AM,11,Wednesday,98,21,10,5,134,normal
2:00:00 AM,11,Wednesday,58,9,25,13,105,normal
2:15:00 AM,11,Wednesday,81,10,39,29,159,high
2:30:00 AM,11,Wednesday,67,20,33,29,149,high
2:45:00 AM,11,Wednesday,68,22,25,16,131,normal
3:00:00 AM,11,Wednesday,47,10,6,22,85,normal
3:15:00 AM,11,Wednesday,45,7,10,27,89,normal
3:30:00 AM,11,Wednesday,54,5,11,24,94,normal
3:45:00 AM,11,Wednesday,61,7,15,28,111,normal
4:00:00 AM,11,Wednesday,56,5,4,29,94,normal
4:15:00 AM,11,Wednesday,23,5,4,27,59,normal
4:30:00 AM,11,Wednesday,31,6,8,23,68,normal
4:45:00 AM,11,Wednesday,27,7,14,28,76,normal
5:00:00 AM,11,Wednesday,30,7,3,30,70,normal
5:15:00 AM,11,Wednesday,114,21,5,14,154,normal
5:30:00 AM,11,Wednesday,46,24,35,16,121,high
5:45:00 AM,11,Wednesday,68,29,29,20,146,high
6:00:00 AM,11,Wednesday,45,16,15,5,81,low
6:15:00 AM,11,Wednesday,86,13,11,20,130,normal
6:30:00 AM,11,Wednesday,44,11,19,15,89,normal
6:45:00 AM,11,Wednesday,45,17,13,20,95,normal
7:00:00 AM,11,Wednesday,106,17,7,12,142,normal
7:15:00 AM,11,Wednesday,44,16,9,13,82,normal
7:30:00 AM,11,Wednesday,77,23,13,9,122,normal
7:45:00 AM,11,Wednesday,53,17,26,8,104,normal
8:00:00 AM,11,Wednesday,138,18,20,8,184,heavy
8:15:00 AM,11,Wednesday,142,24,39,9,214,heavy
8:30:00 AM,11,Wednesday,114,25,21,7,167,normal
8:45:00 AM,11,Wednesday,116,35,42,6,199,heavy
9:00:00 AM,11,Wednesday,149,22,37,8,216,heavy
9:15:00 AM,11,Wednesday,100,12,39,7,158,high
9:30:00 AM,11,Wednesday,101,23,45,5,174,heavy
9:45:00 AM,11,Wednesday,122,40,48,10,220,heavy
10:00:00 AM,11,Wednesday,112,34,39,9,194,heavy
10:15:00 AM,11,Wednesday,112,12,41,5,170,heavy
10:30:00 AM,11,Wednesday,116,22,23,7,168,heavy
10:45:00 AM,11,Wednesday,90,13,15,33,151,high
11:00:00 AM,11,Wednesday,85,14,14,13,126,normal
11:15:00 AM,11,Wednesday,59,25,13,27,124,high
11:30:00 AM,11,Wednesday,108,5,15,22,150,high
11:45:00 AM,11,Wednesday,75,8,16,25,124,high
12:00:00 PM,11,Wednesday,96,15,12,27,150,high
12:15:00 PM,11,Wednesday,61,17,10,8,96,low
12:30:00 PM,11,Wednesday,84,25,20,30,159,high
12:45:00 PM,11,Wednesday,55,9,12,19,95,normal
1:00:00 PM,11,Wednesday,65,16,12,32,125,high
1:15:00 PM,11,Wednesday,87,16,10,16,129,normal
1:30:00 PM,11,Wednesday,75,5,12,21,113,high
1:45:00 PM,11,Wednesday,82,16,14,34,146,high
2:00:00 PM,11,Wednesday,11,3,0,34,48,normal
2:15:00 PM,11,Wednesday,15,5,0,14,34,normal
2:30:00 PM,11,Wednesday,18,5,1,13,37,normal
2:45:00 PM,11,Wednesday,19,2,1,34,56,normal
3:00:00 PM,11,Wednesday,20,4,1,26,51,normal
3:15:00 PM,11,Wednesday,14,4,0,10,28,low
3:30:00 PM,11,Wednesday,11,1,1,36,49,normal
3:45:00 PM,11,Wednesday,10,2,1,15,28,normal
4:00:00 PM,11,Wednesday,10,3,0,33,46,normal
4:15:00 PM,11,Wednesday,14,3,0,23,40,normal
4:30:00 PM,11,Wednesday,11,5,1,11,28,low
4:45:00 PM,11,Wednesday,10,1,1,34,46,normal
5:00:00 PM,11,Wednesday,20,4,1,17,42,normal
5:15:00 PM,11,Wednesday,17,5,0,24,46,normal
5:30:00 PM,11,Wednesday,12,2,1,18,33,normal
5:45:00 PM,11,Wednesday,15,0,1,16,32,normal
6:00:00 PM,11,Wednesday,19,5,0,15,39,normal
6:15:00 PM,11,Wednesday,11,3,1,39,54,normal
6:30:00 PM,11,Wednesday,14,5,0,10,29,low
6:45:00 PM,11,Wednesday,20,0,1,33,54,normal
7:00:00 PM,11,Wednesday,13,1,1,33,48,normal
7:15:00 PM,11,Wednesday,18,2,1,12,33,low
7:30:00 PM,11,Wednesday,19,2,1,23,45,normal
7:45:00 PM,11,Wednesday,10,4,0,36,50,normal
8:00:00 PM,11,Wednesday,13,4,0,17,34,normal
8:15:00 PM,11,Wednesday,86,28,2,18,134,normal
8:30:00 PM,11,Wednesday,59,29,9,14,111,normal
8:45:00 PM,11,Wednesday,102,20,9,13,144,normal
9:00:00 PM,11,Wednesday,114,28,8,16,166,normal
9:15:00 PM,11,Wednesday,87,23,5,0,115,normal
9:30:00 PM,11,Wednesday,88,5,8,13,114,normal
9:45:00 PM,11,Wednesday,83,6,4,9,102,low
10:00:00 PM,11,Wednesday,150,19,24,3,196,heavy
10:15:00 PM,11,Wednesday,148,35,46,1,230,heavy
10:30:00 PM,11,Wednesday,146,23,23,4,196,heavy
10:45:00 PM,11,Wednesday,140,21,39,3,203,heavy
11:00:00 PM,11,Wednesday,149,36,35,1,221,heavy
11:15:00 PM,11,Wednesday,125,34,42,0,201,heavy
11:30:00 PM,11,Wednesday,147,34,20,5,206,heavy
11:45:00 PM,11,Wednesday,128,33,21,4,186,heavy
12:00:00 AM,12,Thursday,111,38,50,5,204,heavy
12:15:00 AM,12,Thursday,144,20,32,4,200,heavy
12:30:00 AM,12,Thursday,121,14,23,1,159,normal
12:45:00 AM,12,Thursday,136,36,40,4,216,heavy
1:00:00 AM,12,Thursday,114,21,23,1,159,normal
1:15:00 AM,12,Thursday,75,17,37,29,158,high
1:30:00 AM,12,Thursday,34,5,27,22,88,normal
1:45:00 AM,12,Thursday,45,6,7,15,73,normal
2:00:00 AM,12,Thursday,65,10,6,27,108,normal
2:15:00 AM,12,Thursday,67,25,20,18,130,normal
2:30:00 AM,12,Thursday,50,25,25,28,128,high
2:45:00 AM,12,Thursday,37,19,38,12,106,normal
3:00:00 AM,12,Thursday,36,8,3,29,76,normal
3:15:00 AM,12,Thursday,63,5,8,23,99,normal
3:30:00 AM,12,Thursday,67,5,7,22,101,normal
3:45:00 AM,12,Thursday,36,9,14,22,81,normal
4:00:00 AM,12,Thursday,57,8,10,22,97,normal
4:15:00 AM,12,Thursday,65,7,14,25,111,normal
4:30:00 AM,12,Thursday,54,10,3,29,96,normal
4:45:00 AM,12,Thursday,41,5,4,25,75,normal
5:00:00 AM,12,Thursday,43,9,3,25,80,normal
5:15:00 AM,12,Thursday,9,27,32,17,85,normal
5:30:00 AM,12,Thursday,101,28,18,20,167,normal
5:45:00 AM,12,Thursday,99,16,16,18,149,normal
6:00:00 AM,12,Thursday,20,27,32,12,91,normal
6:15:00 AM,12,Thursday,96,16,39,17,168,heavy
6:30:00 AM,12,Thursday,62,28,18,20,128,normal
6:45:00 AM,12,Thursday,58,27,17,5,107,normal
7:00:00 AM,12,Thursday,60,18,28,12,118,high
7:15:00 AM,12,Thursday,81,26,13,17,137,normal
7:30:00 AM,12,Thursday,118,15,27,13,173,heavy
7:45:00 AM,12,Thursday,53,12,25,20,110,normal
8:00:00 AM,12,Thursday,132,12,27,9,180,heavy
8:15:00 AM,12,Thursday,149,14,50,5,218,heavy
8:30:00 AM,12,Thursday,106,35,41,5,187,heavy
8:45:00 AM,12,Thursday,150,29,27,7,213,heavy
9:00:00 AM,12,Thursday,110,30,46,5,191,heavy
9:15:00 AM,12,Thursday,129,35,34,5,203,heavy
9:30:00 AM,12,Thursday,133,21,26,5,185,heavy
9:45:00 AM,12,Thursday,148,34,45,7,234,heavy
10:00:00 AM,12,Thursday,144,39,43,8,234,heavy
10:15:00 AM,12,Thursday,126,27,44,8,205,heavy
10:30:00 AM,12,Thursday,103,34,49,5,191,heavy
10:45:00 AM,12,Thursday,96,7,13,30,146,high
11:00:00 AM,12,Thursday,54,17,17,19,107,normal
11:15:00 AM,12,Thursday,98,16,17,15,146,normal
11:30:00 AM,12,Thursday,72,6,19,8,105,normal
11:45:00 AM,12,Thursday,69,23,12,31,135,high
12:00:00 PM,12,Thursday,85,13,16,24,138,high
12:15:00 PM,12,Thursday,102,22,12,9,145,normal
12:30:00 PM,12,Thursday,103,14,20,14,151,normal
12:45:00 PM,12,Thursday,80,12,10,22,124,high
1:00:00 PM,12,Thursday,63,18,11,5,97,low
1:15:00 PM,12,Thursday,84,21,13,9,127,normal
1:30:00 PM,12,Thursday,72,10,10,29,121,high
1:45:00 PM,12,Thursday,79,22,17,13,131,normal
2:00:00 PM,12,Thursday,12,5,0,27,44,normal
2:15:00 PM,12,Thursday,19,1,1,38,59,normal
2:30:00 PM,12,Thursday,14,3,0,33,50,normal
2:45:00 PM,12,Thursday,16,3,1,37,57,normal
3:00:00 PM,12,Thursday,14,5,0,37,56,normal
3:15:00 PM,12,Thursday,11,2,1,20,34,normal
3:30:00 PM,12,Thursday,20,3,0,25,48,normal
3:45:00 PM,12,Thursday,20,0,1,30,51,normal
4:00:00 PM,12,Thursday,13,2,1,17,33,normal
4:15:00 PM,12,Thursday,20,1,1,19,41,normal
4:30:00 PM,12,Thursday,10,2,1,12,25,low
4:45:00 PM,12,Thursday,14,2,0,25,41,normal
5:00:00 PM,12,Thursday,12,0,1,16,29,normal
5:15:00 PM,12,Thursday,11,5,1,31,48,normal
5:30:00 PM,12,Thursday,13,1,1,16,31,normal
5:45:00 PM,12,Thursday,17,3,0,10,30,low
6:00:00 PM,12,Thursday,11,1,0,22,34,normal
6:15:00 PM,12,Thursday,10,4,1,16,31,normal
6:30:00 PM,12,Thursday,15,3,1,32,51,normal
6:45:00 PM,12,Thursday,10,0,0,22,32,normal
7:00:00 PM,12,Thursday,20,1,1,16,38,normal
7:15:00 PM,12,Thursday,16,1,1,15,33,normal
7:30:00 PM,12,Thursday,14,4,1,32,51,normal
7:45:00 PM,12,Thursday,16,1,1,37,55,normal
8:00:00 PM,12,Thursday,10,2,1,36,49,normal
8:15:00 PM,12,Thursday,96,18,7,2,123,normal
8:30:00 PM,12,Thursday,51,14,0,5,70,low
8:45:00 PM,12,Thursday,63,25,2,8,98,low
9:00:00 PM,12,Thursday,72,7,1,4,84,low
9:15:00 PM,12,Thursday,86,18,6,1,111,low
9:30:00 PM,12,Thursday,105,4,4,20,133,normal
9:45:00 PM,12,Thursday,117,10,10,18,155,normal
10:00:00 PM,12,Thursday,120,36,32,0,188,heavy
10:15:00 PM,12,Thursday,135,20,31,0,186,heavy
10:30:00 PM,12,Thursday,112,40,42,3,197,heavy
10:45:00 PM,12,Thursday,135,13,20,3,171,heavy
11:00:00 PM,12,Thursday,105,35,24,2,166,normal
11:15:00 PM,12,Thursday,150,25,36,0,211,heavy
11:30:00 PM,12,Thursday,108,27,23,2,160,normal
11:45:00 PM,12,Thursday,108,40,45,1,194,heavy
12:00:00 AM,13,Friday,118,19,21,1,159,normal
12:15:00 AM,13,Friday,131,18,41,1,191,heavy
12:30:00 AM,13,Friday,148,31,20,4,203,heavy
12:45:00 AM,13,Friday,120,26,22,1,169,heavy
1:00:00 AM,13,Friday,147,12,32,0,191,heavy
1:15:00 AM,13,Friday,73,9,35,12,129,high
1:30:00 AM,13,Friday,93,21,22,29,165,high
1:45:00 AM,13,Friday,66,2,10,28,106,normal
2:00:00 AM,13,Friday,18,6,6,6,36,low
2:15:00 AM,13,Friday,78,1,16,30,125,high
2:30:00 AM,13,Friday,69,15,24,20,128,normal
2:45:00 AM,13,Friday,82,2,40,17,141,high
3:00:00 AM,13,Friday,57,9,5,23,94,normal
3:15:00 AM,13,Friday,25,5,14,26,70,normal
3:30:00 AM,13,Friday,40,9,15,28,92,normal
3:45:00 AM,13,Friday,52,6,13,21,92,normal
4:00:00 AM,13,Friday,45,8,13,29,95,normal
4:15:00 AM,13,Friday,67,10,7,25,109,normal
4:30:00 AM,13,Friday,20,8,14,30,72,normal
4:45:00 AM,13,Friday,44,8,4,29,85,normal
5:00:00 AM,13,Friday,63,5,8,29,105,normal
5:15:00 AM,13,Friday,119,15,20,13,167,normal
5:30:00 AM,13,Friday,103,10,23,7,143,normal
5:45:00 AM,13,Friday,42,14,15,14,85,normal
6:00:00 AM,13,Friday,67,20,24,12,123,normal
6:15:00 AM,13,Friday,56,18,29,17,120,high
6:30:00 AM,13,Friday,65,16,32,15,128,high
6:45:00 AM,13,Friday,107,11,26,19,163,high
7:00:00 AM,13,Friday,11,18,22,10,61,normal
7:15:00 AM,13,Friday,28,15,27,12,82,normal
7:30:00 AM,13,Friday,45,17,7,6,75,low
7:45:00 AM,13,Friday,66,12,27,6,111,normal
8:00:00 AM,13,Friday,104,40,22,9,175,heavy
8:15:00 AM,13,Friday,113,21,26,5,165,high
8:30:00 AM,13,Friday,120,29,37,6,192,heavy
8:45:00 AM,13,Friday,129,10,39,6,184,heavy
9:00:00 AM,13,Friday,119,29,40,10,198,heavy
9:15:00 AM,13,Friday,119,25,32,9,185,heavy
9:30:00 AM,13,Friday,123,10,30,7,170,heavy
9:45:00 AM,13,Friday,111,33,28,5,177,heavy
10:00:00 AM,13,Friday,110,12,47,8,177,heavy
10:15:00 AM,13,Friday,139,15,43,9,206,heavy
10:30:00 AM,13,Friday,132,29,25,7,193,heavy
10:45:00 AM,13,Friday,51,8,18,18,95,normal
11:00:00 AM,13,Friday,76,5,14,20,115,normal
11:15:00 AM,13,Friday,53,15,13,23,104,normal
11:30:00 AM,13,Friday,50,25,19,9,103,normal
11:45:00 AM,13,Friday,86,24,20,34,164,high
12:00:00 PM,13,Friday,67,23,14,13,117,normal
12:15:00 PM,13,Friday,54,9,15,7,85,low
12:30:00 PM,13,Friday,59,12,16,35,122,high
12:45:00 PM,13,Friday,109,25,15,5,154,normal
1:00:00 PM,13,Friday,73,18,10,35,136,high
1:15:00 PM,13,Friday,65,24,14,19,122,normal
1:30:00 PM,13,Friday,94,10,11,22,137,high
1:45:00 PM,13,Friday,106,9,12,31,158,high
2:00:00 PM,13,Friday,18,3,0,11,32,low
2:15:00 PM,13,Friday,17,1,1,36,55,normal
2:30:00 PM,13,Friday,12,0,0,22,34,normal
2:45:00 PM,13,Friday,11,1,0,19,31,normal
3:00:00 PM,13,Friday,16,1,0,32,49,normal
3:15:00 PM,13,Friday,12,3,1,13,29,normal
3:30:00 PM,13,Friday,14,4,1,27,46,normal
3:45:00 PM,13,Friday,11,3,1,37,52,normal
4:00:00 PM,13,Friday,17,2,0,18,37,normal
4:15:00 PM,13,Friday,18,4,1,39,62,normal
4:30:00 PM,13,Friday,20,4,0,32,56,normal
4:45:00 PM,13,Friday,15,0,0,28,43,normal
5:00:00 PM,13,Friday,11,4,0,12,27,low
5:15:00 PM,13,Friday,19,5,1,35,60,normal
5:30:00 PM,13,Friday,15,0,1,26,42,normal
5:45:00 PM,13,Friday,11,4,0,31,46,normal
6:00:00 PM,13,Friday,19,2,1,33,55,normal
6:15:00 PM,13,Friday,12,4,1,29,46,normal
6:30:00 PM,13,Friday,15,5,1,16,37,normal
6:45:00 PM,13,Friday,14,4,1,21,40,normal
7:00:00 PM,13,Friday,19,4,1,17,41,normal
7:15:00 PM,13,Friday,10,2,1,12,25,low
7:30:00 PM,13,Friday,10,0,0,11,21,low
7:45:00 PM,13,Friday,20,4,1,33,58,normal
8:00:00 PM,13,Friday,10,1,0,12,23,low
8:15:00 PM,13,Friday,73,12,5,5,95,low
8:30:00 PM,13,Friday,95,15,4,19,133,normal
8:45:00 PM,13,Friday,81,19,3,13,116,normal
9:00:00 PM,13,Friday,119,25,10,9,163,normal
9:15:00 PM,13,Friday,80,10,4,15,109,normal
9:30:00 PM,13,Friday,102,24,3,16,145,normal
9:45:00 PM,13,Friday,68,17,6,10,101,low
10:00:00 PM,13,Friday,109,40,38,0,187,heavy
10:15:00 PM,13,Friday,124,25,31,1,181,heavy
10:30:00 PM,13,Friday,126,22,21,1,170,heavy
10:45:00 PM,13,Friday,120,31,29,5,185,heavy
11:00:00 PM,13,Friday,101,20,47,5,173,heavy
11:15:00 PM,13,Friday,139,40,48,2,229,heavy
11:30:00 PM,13,Friday,116,23,23,4,166,normal
11:45:00 PM,13,Friday,101,14,24,0,139,normal
12:00:00 AM,14,Saturday,137,40,21,5,203,heavy
12:15:00 AM,14,Saturday,131,26,36,0,193,heavy
12:30:00 AM,14,Saturday,114,27,45,4,190,heavy
12:45:00 AM,14,Saturday,102,14,46,1,163,high
1:00:00 AM,14,Saturday,116,24,32,5,177,heavy
1:15:00 AM,14,Saturday,29,10,21,12,72,normal
1:30:00 AM,14,Saturday,41,12,15,10,78,low
1:45:00 AM,14,Saturday,41,9,7,27,84,normal
2:00:00 AM,14,Saturday,90,25,26,10,151,high
2:15:00 AM,14,Saturday,64,25,17,20,126,normal
2:30:00 AM,14,Saturday,64,10,17,23,114,high
2:45:00 AM,14,Saturday,69,17,5,28,119,high
3:00:00 AM,14,Saturday,59,9,9,21,98,normal
3:15:00 AM,14,Saturday,44,10,12,29,95,normal
3:30:00 AM,14,Saturday,43,5,6,26,80,normal
3:45:00 AM,14,Saturday,65,7,10,21,103,normal
4:00:00 AM,14,Saturday,29,5,12,21,67,normal
4:15:00 AM,14,Saturday,24,9,8,20,61,normal
4:30:00 AM,14,Saturday,44,6,4,26,80,normal
4:45:00 AM,14,Saturday,35,10,12,24,81,normal
5:00:00 AM,14,Saturday,43,10,15,21,89,normal
5:15:00 AM,14,Saturday,45,17,24,11,97,normal
5:30:00 AM,14,Saturday,108,21,37,14,180,heavy
5:45:00 AM,14,Saturday,53,19,33,9,114,high
6:00:00 AM,14,Saturday,75,23,31,13,142,high
6:15:00 AM,14,Saturday,70,18,5,19,112,normal
6:30:00 AM,14,Saturday,52,25,15,19,111,normal
6:45:00 AM,14,Saturday,9,18,24,9,60,normal
7:00:00 AM,14,Saturday,47,21,9,18,95,normal
7:15:00 AM,14,Saturday,116,20,17,19,172,heavy
7:30:00 AM,14,Saturday,65,14,6,9,94,low
7:45:00 AM,14,Saturday,93,12,13,13,131,normal
8:00:00 AM,14,Saturday,100,21,45,9,175,heavy
8:15:00 AM,14,Saturday,121,24,31,6,182,heavy
8:30:00 AM,14,Saturday,110,15,50,5,180,heavy
8:45:00 AM,14,Saturday,103,17,28,5,153,high
9:00:00 AM,14,Saturday,136,38,20,5,199,heavy
9:15:00 AM,14,Saturday,119,22,32,9,182,heavy
9:30:00 AM,14,Saturday,132,17,36,5,190,heavy
9:45:00 AM,14,Saturday,147,10,41,5,203,heavy
10:00:00 AM,14,Saturday,111,12,44,6,173,heavy
10:15:00 AM,14,Saturday,102,27,32,5,166,high
10:30:00 AM,14,Saturday,137,25,29,7,198,heavy
10:45:00 AM,14,Saturday,71,17,15,31,134,high
11:00:00 AM,14,Saturday,64,25,11,15,115,normal
11:15:00 AM,14,Saturday,70,16,15,29,130,high
11:30:00 AM,14,Saturday,91,9,11,32,143,high
11:45:00 AM,14,Saturday,95,6,11,35,147,high
12:00:00 PM,14,Saturday,76,16,10,31,133,high
12:15:00 PM,14,Saturday,87,17,18,7,129,normal
12:30:00 PM,14,Saturday,63,22,12,29,126,high
12:45:00 PM,14,Saturday,56,17,20,8,101,normal
1:00:00 PM,14,Saturday,102,18,19,29,168,heavy
1:15:00 PM,14,Saturday,60,23,10,13,106,normal
1:30:00 PM,14,Saturday,88,6,18,25,137,high
1:45:00 PM,14,Saturday,104,15,10,32,161,high
2:00:00 PM,14,Saturday,16,1,1,26,44,normal
2:15:00 PM,14,Saturday,12,1,0,12,25,low
2:30:00 PM,14,Saturday,16,1,0,29,46,normal
2:45:00 PM,14,Saturday,13,5,0,31,49,normal
3:00:00 PM,14,Saturday,20,1,1,27,49,normal
3:15:00 PM,14,Saturday,18,0,0,29,47,normal
3:30:00 PM,14,Saturday,16,3,1,26,46,normal
3:45:00 PM,14,Saturday,18,0,0,21,39,normal
4:00:00 PM,14,Saturday,11,5,0,24,40,normal
4:15:00 PM,14,Saturday,13,1,0,10,24,low
4:30:00 PM,14,Saturday,10,1,0,26,37,normal
4:45:00 PM,14,Saturday,19,5,1,22,47,normal
5:00:00 PM,14,Saturday,20,0,0,10,30,low
5:15:00 PM,14,Saturday,16,4,1,39,60,normal
5:30:00 PM,14,Saturday,19,1,1,11,32,low
5:45:00 PM,14,Saturday,20,4,0,38,62,normal
6:00:00 PM,14,Saturday,15,1,1,15,32,normal
6:15:00 PM,14,Saturday,10,0,0,33,43,normal
6:30:00 PM,14,Saturday,20,5,0,24,49,normal
6:45:00 PM,14,Saturday,12,2,1,35,50,normal
7:00:00 PM,14,Saturday,10,4,1,37,52,normal
7:15:00 PM,14,Saturday,15,4,0,38,57,normal
7:30:00 PM,14,Saturday,19,0,1,39,59,normal
7:45:00 PM,14,Saturday,16,4,0,35,55,normal
8:00:00 PM,14,Saturday,20,3,1,35,59,normal
8:15:00 PM,14,Saturday,118,1,0,4,123,normal
8:30:00 PM,14,Saturday,89,20,4,17,130,normal
8:45:00 PM,14,Saturday,120,18,6,13,157,normal
9:00:00 PM,14,Saturday,85,7,3,18,113,normal
9:15:00 PM,14,Saturday,99,8,2,14,123,normal
9:30:00 PM,14,Saturday,59,25,2,7,93,low
9:45:00 PM,14,Saturday,58,25,2,5,90,low
10:00:00 PM,14,Saturday,113,40,36,4,193,heavy
10:15:00 PM,14,Saturday,113,16,50,2,181,heavy
10:30:00 PM,14,Saturday,121,27,50,4,202,heavy
10:45:00 PM,14,Saturday,150,17,28,0,195,heavy
11:00:00 PM,14,Saturday,136,29,23,0,188,heavy
11:15:00 PM,14,Saturday,142,32,27,2,203,heavy
11:30:00 PM,14,Saturday,106,32,42,2,182,heavy
11:45:00 PM,14,Saturday,103,21,20,0,144,normal
12:00:00 AM,15,Sunday,131,19,26,1,177,heavy
12:15:00 AM,15,Sunday,133,23,21,3,180,heavy
12:30:00 AM,15,Sunday,123,17,50,1,191,heavy
12:45:00 AM,15,Sunday,124,21,35,2,182,heavy
1:00:00 AM,15,Sunday,136,26,20,4,186,heavy
1:15:00 AM,15,Sunday,92,10,39,19,160,high
1:30:00 AM,15,Sunday,82,7,13,19,121,normal
1:45:00 AM,15,Sunday,42,2,28,27,99,normal
2:00:00 AM,15,Sunday,24,17,17,9,67,normal
2:15:00 AM,15,Sunday,42,19,17,12,90,normal
2:30:00 AM,15,Sunday,100,12,5,23,140,high
2:45:00 AM,15,Sunday,11,25,30,22,88,normal
3:00:00 AM,15,Sunday,27,7,10,22,66,normal
3:15:00 AM,15,Sunday,38,7,11,20,76,normal
3:30:00 AM,15,Sunday,49,10,6,27,92,normal
3:45:00 AM,15,Sunday,66,9,7,28,110,normal
4:00:00 AM,15,Sunday,70,8,3,22,103,normal
4:15:00 AM,15,Sunday,58,7,6,27,98,normal
4:30:00 AM,15,Sunday,53,9,13,29,104,normal
4:45:00 AM,15,Sunday,22,5,6,26,59,normal
5:00:00 AM,15,Sunday,40,10,11,28,89,normal
5:15:00 AM,15,Sunday,58,13,10,12,93,low
5:30:00 AM,15,Sunday,60,25,24,17,126,normal
5:45:00 AM,15,Sunday,25,11,24,17,77,normal
6:00:00 AM,15,Sunday,22,28,11,18,79,normal
6:15:00 AM,15,Sunday,6,11,37,15,69,normal
6:30:00 AM,15,Sunday,92,18,34,18,162,high
6:45:00 AM,15,Sunday,97,17,38,20,172,heavy
7:00:00 AM,15,Sunday,92,18,31,6,147,high
7:15:00 AM,15,Sunday,74,12,17,16,119,normal
7:30:00 AM,15,Sunday,67,22,7,5,101,low
7:45:00 AM,15,Sunday,84,20,25,15,144,normal
8:00:00 AM,15,Sunday,144,15,42,8,209,heavy
8:15:00 AM,15,Sunday,120,11,47,7,185,heavy
8:30:00 AM,15,Sunday,108,10,36,6,160,high
8:45:00 AM,15,Sunday,141,13,50,6,210,heavy
9:00:00 AM,15,Sunday,121,37,29,8,195,heavy
9:15:00 AM,15,Sunday,142,40,22,6,210,heavy
9:30:00 AM,15,Sunday,137,23,28,7,195,heavy
9:45:00 AM,15,Sunday,117,10,27,8,162,high
10:00:00 AM,15,Sunday,100,16,37,7,160,high
10:15:00 AM,15,Sunday,148,11,42,8,209,heavy
10:30:00 AM,15,Sunday,148,27,39,6,220,heavy
10:45:00 AM,15,Sunday,65,18,20,21,124,high
11:00:00 AM,15,Sunday,75,9,14,6,104,low
11:15:00 AM,15,Sunday,85,15,20,29,149,high
11:30:00 AM,15,Sunday,57,21,20,18,116,normal
11:45:00 AM,15,Sunday,50,7,13,30,100,normal
12:00:00 PM,15,Sunday,87,21,14,34,156,high
12:15:00 PM,15,Sunday,64,24,11,6,105,low
12:30:00 PM,15,Sunday,76,6,18,14,114,normal
12:45:00 PM,15,Sunday,69,11,12,8,100,low
1:00:00 PM,15,Sunday,76,9,17,14,116,normal
1:15:00 PM,15,Sunday,94,8,15,5,122,normal
1:30:00 PM,15,Sunday,104,10,16,33,163,high
1:45:00 PM,15,Sunday,98,13,13,33,157,high
2:00:00 PM,15,Sunday,13,5,0,18,36,normal
2:15:00 PM,15,Sunday,17,1,0,11,29,low
2:30:00 PM,15,Sunday,18,2,1,34,55,normal
2:45:00 PM,15,Sunday,11,1,0,35,47,normal
3:00:00 PM,15,Sunday,17,4,0,11,32,low
3:15:00 PM,15,Sunday,17,1,1,23,42,normal
3:30:00 PM,15,Sunday,17,2,0,23,42,normal
3:45:00 PM,15,Sunday,16,4,1,30,51,normal
4:00:00 PM,15,Sunday,15,5,1,23,44,normal
4:15:00 PM,15,Sunday,18,0,0,31,49,normal
4:30:00 PM,15,Sunday,10,1,0,17,28,normal
4:45:00 PM,15,Sunday,13,2,0,32,47,normal
5:00:00 PM,15,Sunday,16,1,0,38,55,normal
5:15:00 PM,15,Sunday,11,4,0,32,47,normal
5:30:00 PM,15,Sunday,12,2,0,26,40,normal
5:45:00 PM,15,Sunday,14,2,1,14,31,normal
6:00:00 PM,15,Sunday,18,2,0,37,57,normal
6:15:00 PM,15,Sunday,17,1,1,22,41,normal
6:30:00 PM,15,Sunday,12,3,0,29,44,normal
6:45:00 PM,15,Sunday,20,5,0,30,55,normal
7:00:00 PM,15,Sunday,17,5,1,19,42,normal
7:15:00 PM,15,Sunday,12,0,1,33,46,normal
7:30:00 PM,15,Sunday,19,1,0,20,40,normal
7:45:00 PM,15,Sunday,11,4,1,38,54,normal
8:00:00 PM,15,Sunday,14,5,0,39,58,normal
8:15:00 PM,15,Sunday,102,20,4,12,138,normal
8:30:00 PM,15,Sunday,92,4,6,18,120,normal
8:45:00 PM,15,Sunday,54,14,10,16,94,normal
9:00:00 PM,15,Sunday,55,15,1,10,81,low
9:15:00 PM,15,Sunday,64,27,5,5,101,low
9:30:00 PM,15,Sunday,52,13,5,15,85,normal
9:45:00 PM,15,Sunday,73,11,4,3,91,low
10:00:00 PM,15,Sunday,106,27,45,5,183,heavy
10:15:00 PM,15,Sunday,145,21,40,5,211,heavy
10:30:00 PM,15,Sunday,133,19,28,5,185,heavy
10:45:00 PM,15,Sunday,117,31,49,0,197,heavy
11:00:00 PM,15,Sunday,146,17,34,0,197,heavy
11:15:00 PM,15,Sunday,101,35,42,3,181,heavy
11:30:00 PM,15,Sunday,103,28,32,1,164,high
11:45:00 PM,15,Sunday,150,10,26,0,186,heavy
12:00:00 AM,16,Monday,135,23,48,0,206,heavy
12:15:00 AM,16,Monday,104,10,48,2,164,high
12:30:00 AM,16,Monday,144,39,50,1,234,heavy
12:45:00 AM,16,Monday,132,10,49,0,191,heavy
1:00:00 AM,16,Monday,142,19,31,1,193,heavy
1:15:00 AM,16,Monday,45,4,30,29,108,normal
1:30:00 AM,16,Monday,27,24,10,5,66,low
1:45:00 AM,16,Monday,85,3,14,16,118,normal
2:00:00 AM,16,Monday,84,11,27,26,148,high
2:15:00 AM,16,Monday,90,4,10,20,124,normal
2:30:00 AM,16,Monday,13,19,39,12,83,normal
2:45:00 AM,16,Monday,11,1,37,9,58,normal
3:00:00 AM,16,Monday,57,10,4,27,98,normal
3:15:00 AM,16,Monday,52,10,9,23,94,normal
3:30:00 AM,16,Monday,38,7,13,21,79,normal
3:45:00 AM,16,Monday,35,7,15,24,81,normal
4:00:00 AM,16,Monday,60,10,12,21,103,normal
4:15:00 AM,16,Monday,70,10,3,30,113,high
4:30:00 AM,16,Monday,34,8,6,30,78,normal
4:45:00 AM,16,Monday,44,6,4,27,81,normal
5:00:00 AM,16,Monday,21,5,4,25,55,normal
5:15:00 AM,16,Monday,106,10,11,11,138,normal
5:30:00 AM,16,Monday,82,30,32,10,154,high
5:45:00 AM,16,Monday,57,12,9,17,95,normal
6:00:00 AM,16,Monday,60,18,21,10,109,normal
6:15:00 AM,16,Monday,79,17,34,8,138,high
6:30:00 AM,16,Monday,78,29,22,13,142,normal
6:45:00 AM,16,Monday,69,14,32,18,133,high
7:00:00 AM,16,Monday,84,25,5,9,123,normal
7:15:00 AM,16,Monday,62,11,28,5,106,normal
7:30:00 AM,16,Monday,33,17,22,18,90,normal
7:45:00 AM,16,Monday,14,21,23,6,64,normal
8:00:00 AM,16,Monday,127,27,40,5,199,heavy
8:15:00 AM,16,Monday,136,10,27,7,180,heavy
8:30:00 AM,16,Monday,148,14,37,9,208,heavy
8:45:00 AM,16,Monday,122,16,28,6,172,heavy
9:00:00 AM,16,Monday,132,12,45,9,198,heavy
9:15:00 AM,16,Monday,136,29,29,10,204,heavy
9:30:00 AM,16,Monday,103,33,48,10,194,heavy
9:45:00 AM,16,Monday,132,37,23,10,202,heavy
10:00:00 AM,16,Monday,136,39,39,6,220,heavy
10:15:00 AM,16,Monday,120,24,36,5,185,heavy
10:30:00 AM,16,Monday,126,34,38,9,207,heavy
10:45:00 AM,16,Monday,80,22,14,18,134,normal
11:00:00 AM,16,Monday,99,9,15,29,152,high
11:15:00 AM,16,Monday,81,21,19,7,128,normal
11:30:00 AM,16,Monday,87,9,16,26,138,high
11:45:00 AM,16,Monday,80,17,13,30,140,high
12:00:00 PM,16,Monday,91,18,18,9,136,normal
12:15:00 PM,16,Monday,90,19,15,13,137,normal
12:30:00 PM,16,Monday,107,19,10,23,159,high
12:45:00 PM,16,Monday,98,11,14,27,150,high
1:00:00 PM,16,Monday,98,18,20,22,158,high
1:15:00 PM,16,Monday,102,5,12,17,136,normal
1:30:00 PM,16,Monday,62,13,16,28,119,high
1:45:00 PM,16,Monday,101,15,12,35,163,high
2:00:00 PM,16,Monday,17,5,1,16,39,normal
2:15:00 PM,16,Monday,10,4,1,37,52,normal
2:30:00 PM,16,Monday,16,4,0,35,55,normal
2:45:00 PM,16,Monday,17,2,0,17,36,normal
3:00:00 PM,16,Monday,17,0,0,27,44,normal
3:15:00 PM,16,Monday,17,4,1,25,47,normal
3:30:00 PM,16,Monday,15,2,0,15,32,normal
3:45:00 PM,16,Monday,20,0,1,12,33,low
4:00:00 PM,16,Monday,16,3,0,28,47,normal
4:15:00 PM,16,Monday,13,2,1,28,44,normal
4:30:00 PM,16,Monday,15,5,0,26,46,normal
4:45:00 PM,16,Monday,15,2,1,16,34,normal
5:00:00 PM,16,Monday,12,3,0,26,41,normal
5:15:00 PM,16,Monday,15,5,0,27,47,normal
5:30:00 PM,16,Monday,20,2,0,17,39,normal
5:45:00 PM,16,Monday,12,2,0,16,30,normal
6:00:00 PM,16,Monday,19,1,0,38,58,normal
6:15:00 PM,16,Monday,16,1,1,32,50,normal
6:30:00 PM,16,Monday,12,0,0,11,23,low
6:45:00 PM,16,Monday,16,5,1,29,51,normal
7:00:00 PM,16,Monday,19,5,1,18,43,normal
7:15:00 PM,16,Monday,11,0,0,15,26,normal
7:30:00 PM,16,Monday,15,4,1,17,37,normal
7:45:00 PM,16,Monday,20,1,0,23,44,normal
8:00:00 PM,16,Monday,10,4,0,36,50,normal
8:15:00 PM,16,Monday,39,14,0,15,68,normal
8:30:00 PM,16,Monday,33,7,3,10,53,low
8:45:00 PM,16,Monday,77,8,7,15,107,normal
9:00:00 PM,16,Monday,80,18,6,11,115,normal
9:15:00 PM,16,Monday,53,11,7,15,86,normal
9:30:00 PM,16,Monday,73,17,6,13,109,normal
9:45:00 PM,16,Monday,77,20,4,13,114,normal
10:00:00 PM,16,Monday,76,14,1,12,103,low
10:15:00 PM,16,Monday,58,14,0,15,87,normal
10:30:00 PM,16,Monday,57,18,7,13,95,normal
10:45:00 PM,16,Monday,80,16,0,10,106,low
11:00:00 PM,16,Monday,38,7,1,13,59,normal
11:15:00 PM,16,Monday,53,20,6,12,91,low
11:30:00 PM,16,Monday,30,9,7,10,56,low
11:45:00 PM,16,Monday,50,19,4,10,83,low
12:00:00 AM,17,Tuesday,31,14,3,14,62,normal
12:15:00 AM,17,Tuesday,28,18,5,10,61,low
12:30:00 AM,17,Tuesday,31,15,4,12,62,low
12:45:00 AM,17,Tuesday,52,19,0,10,81,low
1:00:00 AM,17,Tuesday,42,9,2,13,66,normal
1:15:00 AM,17,Tuesday,151,55,27,2,235,heavy
1:30:00 AM,17,Tuesday,180,69,29,1,279,heavy
1:45:00 AM,17,Tuesday,149,41,23,3,216,heavy
2:00:00 AM,17,Tuesday,167,60,27,3,257,heavy
2:15:00 AM,17,Tuesday,134,45,22,3,204,heavy
2:30:00 AM,17,Tuesday,180,62,26,4,272,heavy
2:45:00 AM,17,Tuesday,156,54,25,3,238,heavy
3:00:00 AM,17,Tuesday,171,60,18,1,250,heavy
3:15:00 AM,17,Tuesday,174,53,10,3,240,heavy
3:30:00 AM,17,Tuesday,154,61,16,3,234,heavy
3:45:00 AM,17,Tuesday,161,53,11,1,226,heavy
4:00:00 AM,17,Tuesday,148,48,13,2,211,heavy
4:15:00 AM,17,Tuesday,136,60,27,2,225,heavy
4:30:00 AM,17,Tuesday,143,68,16,0,227,heavy
4:45:00 AM,17,Tuesday,152,51,22,2,227,heavy
5:00:00 AM,17,Tuesday,132,58,15,4,209,heavy
5:15:00 AM,17,Tuesday,155,58,15,4,232,heavy
5:30:00 AM,17,Tuesday,144,62,12,3,221,heavy
5:45:00 AM,17,Tuesday,161,51,20,1,233,heavy
6:00:00 AM,17,Tuesday,137,46,13,2,198,heavy
6:15:00 AM,17,Tuesday,149,61,16,1,227,heavy
6:30:00 AM,17,Tuesday,158,46,20,1,225,heavy
6:45:00 AM,17,Tuesday,134,65,22,0,221,heavy
7:00:00 AM,17,Tuesday,134,65,10,2,211,heavy
7:15:00 AM,17,Tuesday,73,24,4,0,101,low
7:30:00 AM,17,Tuesday,64,23,21,1,109,normal
7:45:00 AM,17,Tuesday,51,27,25,2,105,normal
8:00:00 AM,17,Tuesday,80,22,17,0,119,normal
8:15:00 AM,17,Tuesday,61,26,8,0,95,low
8:30:00 AM,17,Tuesday,75,24,8,0,107,low
8:45:00 AM,17,Tuesday,82,20,15,2,119,normal
9:00:00 AM,17,Tuesday,53,28,21,1,103,normal
9:15:00 AM,17,Tuesday,68,29,14,0,111,low
9:30:00 AM,17,Tuesday,63,28,22,0,113,normal
9:45:00 AM,17,Tuesday,76,30,20,1,127,normal
10:00:00 AM,17,Tuesday,66,23,10,0,99,low
10:15:00 AM,17,Tuesday,50,23,1,0,74,low
10:30:00 AM,17,Tuesday,60,29,22,2,113,normal
10:45:00 AM,17,Tuesday,75,26,11,0,112,normal
11:00:00 AM,17,Tuesday,81,22,18,2,123,normal
11:15:00 AM,17,Tuesday,33,6,0,4,43,low
11:30:00 AM,17,Tuesday,21,5,6,15,47,normal
11:45:00 AM,17,Tuesday,22,7,1,2,32,low
12:00:00 PM,17,Tuesday,31,6,0,15,52,normal
12:15:00 PM,17,Tuesday,41,8,3,2,54,low
12:30:00 PM,17,Tuesday,24,6,5,11,46,low
12:45:00 PM,17,Tuesday,45,6,6,10,67,low
1:00:00 PM,17,Tuesday,24,11,6,2,43,low
1:15:00 PM,17,Tuesday,47,6,2,12,67,low
1:30:00 PM,17,Tuesday,46,1,1,4,52,low
1:45:00 PM,17,Tuesday,26,3,2,3,34,low
2:00:00 PM,17,Tuesday,20,4,0,39,63,normal
2:15:00 PM,17,Tuesday,20,1,1,27,49,normal
2:30:00 PM,17,Tuesday,19,0,1,17,37,normal
2:45:00 PM,17,Tuesday,11,3,1,19,34,normal
3:00:00 PM,17,Tuesday,17,5,1,31,54,normal
3:15:00 PM,17,Tuesday,19,4,0,12,35,low
3:30:00 PM,17,Tuesday,11,1,0,38,50,normal
3:45:00 PM,17,Tuesday,12,0,0,17,29,normal
4:00:00 PM,17,Tuesday,18,0,0,27,45,normal
4:15:00 PM,17,Tuesday,19,4,0,14,37,normal
4:30:00 PM,17,Tuesday,13,2,0,28,43,normal
4:45:00 PM,17,Tuesday,18,4,1,23,46,normal
5:00:00 PM,17,Tuesday,20,0,0,11,31,low
5:15:00 PM,17,Tuesday,11,4,1,22,38,normal
5:30:00 PM,17,Tuesday,15,2,0,18,35,normal
5:45:00 PM,17,Tuesday,16,3,0,34,53,normal
6:00:00 PM,17,Tuesday,11,2,0,18,31,normal
6:15:00 PM,17,Tuesday,17,4,1,38,60,normal
6:30:00 PM,17,Tuesday,20,4,1,28,53,normal
6:45:00 PM,17,Tuesday,19,0,1,37,57,normal
7:00:00 PM,17,Tuesday,10,2,1,34,47,normal
7:15:00 PM,17,Tuesday,19,0,0,17,36,normal
7:30:00 PM,17,Tuesday,15,0,0,30,45,normal
7:45:00 PM,17,Tuesday,10,2,0,31,43,normal
8:00:00 PM,17,Tuesday,18,3,0,17,38,normal
8:15:00 PM,17,Tuesday,97,22,4,18,141,normal
8:30:00 PM,17,Tuesday,111,12,9,17,149,normal
8:45:00 PM,17,Tuesday,108,10,5,17,140,normal
9:00:00 PM,17,Tuesday,74,24,10,20,128,normal
9:15:00 PM,17,Tuesday,114,4,8,20,146,normal
9:30:00 PM,17,Tuesday,91,16,5,11,123,normal
9:45:00 PM,17,Tuesday,66,3,9,19,97,normal
10:00:00 PM,17,Tuesday,104,32,23,5,164,normal
10:15:00 PM,17,Tuesday,128,18,31,3,180,heavy
10:30:00 PM,17,Tuesday,127,24,27,0,178,heavy
10:45:00 PM,17,Tuesday,130,31,22,0,183,heavy
11:00:00 PM,17,Tuesday,108,13,38,1,160,high
11:15:00 PM,17,Tuesday,116,22,37,2,177,heavy
11:30:00 PM,17,Tuesday,143,28,27,4,202,heavy
11:45:00 PM,17,Tuesday,118,32,21,5,176,heavy
12:00:00 AM,18,Wednesday,121,35,32,0,188,heavy
12:15:00 AM,18,Wednesday,109,28,39,2,178,heavy
12:30:00 AM,18,Wednesday,135,11,23,5,174,heavy
12:45:00 AM,18,Wednesday,100,30,29,2,161,high
1:00:00 AM,18,Wednesday,138,32,26,4,200,heavy
1:15:00 AM,18,Wednesday,29,9,21,23,82,normal
1:30:00 AM,18,Wednesday,36,17,7,30,90,normal
1:45:00 AM,18,Wednesday,42,9,37,28,116,high
2:00:00 AM,18,Wednesday,80,6,12,6,104,low
2:15:00 AM,18,Wednesday,37,21,28,6,92,normal
2:30:00 AM,18,Wednesday,44,17,27,30,118,high
2:45:00 AM,18,Wednesday,25,12,13,5,55,low
3:00:00 AM,18,Wednesday,36,9,9,30,84,normal
3:15:00 AM,18,Wednesday,63,7,10,29,109,normal
3:30:00 AM,18,Wednesday,20,5,13,22,60,normal
3:45:00 AM,18,Wednesday,53,8,6,23,90,normal
4:00:00 AM,18,Wednesday,41,7,5,26,79,normal
4:15:00 AM,18,Wednesday,36,9,13,29,87,normal
4:30:00 AM,18,Wednesday,65,10,8,22,105,normal
4:45:00 AM,18,Wednesday,55,6,5,27,93,normal
5:00:00 AM,18,Wednesday,63,8,15,30,116,high
5:15:00 AM,18,Wednesday,19,26,32,18,95,normal
5:30:00 AM,18,Wednesday,84,11,11,9,115,normal
5:45:00 AM,18,Wednesday,110,23,34,9,176,heavy
6:00:00 AM,18,Wednesday,46,20,18,5,89,normal
6:15:00 AM,18,Wednesday,67,12,10,20,109,normal
6:30:00 AM,18,Wednesday,42,25,20,19,106,normal
6:45:00 AM,18,Wednesday,87,17,18,6,128,normal
7:00:00 AM,18,Wednesday,45,24,31,11,111,normal
7:15:00 AM,18,Wednesday,80,26,35,6,147,high
7:30:00 AM,18,Wednesday,83,18,6,15,122,normal
7:45:00 AM,18,Wednesday,68,19,15,11,113,normal
8:00:00 AM,18,Wednesday,101,37,48,9,195,heavy
8:15:00 AM,18,Wednesday,149,32,29,10,220,heavy
8:30:00 AM,18,Wednesday,136,21,33,9,199,heavy
8:45:00 AM,18,Wednesday,105,20,23,7,155,normal
9:00:00 AM,18,Wednesday,125,12,20,8,165,normal
9:15:00 AM,18,Wednesday,125,14,26,5,170,heavy
9:30:00 AM,18,Wednesday,118,28,23,8,177,heavy
9:45:00 AM,18,Wednesday,114,32,45,6,197,heavy
10:00:00 AM,18,Wednesday,123,37,46,8,214,heavy
10:15:00 AM,18,Wednesday,115,23,22,7,167,normal
10:30:00 AM,18,Wednesday,111,25,35,10,181,heavy
10:45:00 AM,18,Wednesday,66,8,11,9,94,low
11:00:00 AM,18,Wednesday,103,12,17,23,155,high
11:15:00 AM,18,Wednesday,94,14,14,24,146,high
11:30:00 AM,18,Wednesday,105,23,15,18,161,normal
11:45:00 AM,18,Wednesday,53,22,14,35,124,high
12:00:00 PM,18,Wednesday,74,10,12,32,128,high
12:15:00 PM,18,Wednesday,71,24,15,26,136,high
12:30:00 PM,18,Wednesday,61,21,15,32,129,high
12:45:00 PM,18,Wednesday,101,25,18,8,152,normal
1:00:00 PM,18,Wednesday,104,22,10,14,150,normal
1:15:00 PM,18,Wednesday,79,20,15,18,132,normal
1:30:00 PM,18,Wednesday,70,20,11,14,115,normal
1:45:00 PM,18,Wednesday,74,16,14,34,138,high
2:00:00 PM,18,Wednesday,20,5,0,21,46,normal
2:15:00 PM,18,Wednesday,16,0,0,36,52,normal
2:30:00 PM,18,Wednesday,14,3,0,20,37,normal
2:45:00 PM,18,Wednesday,14,1,1,30,46,normal
3:00:00 PM,18,Wednesday,17,0,1,12,30,low
3:15:00 PM,18,Wednesday,14,0,0,14,28,normal
3:30:00 PM,18,Wednesday,18,5,0,40,63,normal
3:45:00 PM,18,Wednesday,17,2,0,18,37,normal
4:00:00 PM,18,Wednesday,14,1,1,35,51,normal
4:15:00 PM,18,Wednesday,14,2,1,26,43,normal
4:30:00 PM,18,Wednesday,16,0,1,37,54,normal
4:45:00 PM,18,Wednesday,14,4,1,32,51,normal
5:00:00 PM,18,Wednesday,19,5,0,12,36,low
5:15:00 PM,18,Wednesday,11,0,1,31,43,normal
5:30:00 PM,18,Wednesday,12,0,0,32,44,normal
5:45:00 PM,18,Wednesday,12,3,0,32,47,normal
6:00:00 PM,18,Wednesday,18,4,1,31,54,normal
6:15:00 PM,18,Wednesday,17,4,1,20,42,normal
6:30:00 PM,18,Wednesday,17,0,0,22,39,normal
6:45:00 PM,18,Wednesday,19,2,1,12,34,low
7:00:00 PM,18,Wednesday,18,2,1,19,40,normal
7:15:00 PM,18,Wednesday,19,5,0,26,50,normal
7:30:00 PM,18,Wednesday,19,5,1,35,60,normal
7:45:00 PM,18,Wednesday,18,0,0,20,38,normal
8:00:00 PM,18,Wednesday,16,0,0,30,46,normal
8:15:00 PM,18,Wednesday,114,30,9,7,160,normal
8:30:00 PM,18,Wednesday,102,17,2,14,135,normal
8:45:00 PM,18,Wednesday,55,4,7,13,79,normal
9:00:00 PM,18,Wednesday,82,2,4,14,102,normal
9:15:00 PM,18,Wednesday,66,16,9,19,110,normal
9:30:00 PM,18,Wednesday,86,5,1,13,105,normal
9:45:00 PM,18,Wednesday,108,24,2,19,153,normal
10:00:00 PM,18,Wednesday,112,30,26,0,168,heavy
10:15:00 PM,18,Wednesday,147,31,46,0,224,heavy
10:30:00 PM,18,Wednesday,116,20,40,2,178,heavy
10:45:00 PM,18,Wednesday,138,13,21,5,177,heavy
11:00:00 PM,18,Wednesday,132,25,40,2,199,heavy
11:15:00 PM,18,Wednesday,124,14,31,4,173,heavy
11:30:00 PM,18,Wednesday,106,27,25,1,159,normal
11:45:00 PM,18,Wednesday,104,24,29,5,162,high
12:00:00 AM,19,Thursday,140,31,21,4,196,heavy
12:15:00 AM,19,Thursday,121,35,37,3,196,heavy
12:30:00 AM,19,Thursday,135,23,37,5,200,heavy
12:45:00 AM,19,Thursday,149,20,30,5,204,heavy
1:00:00 AM,19,Thursday,117,14,39,0,170,heavy
1:15:00 AM,19,Thursday,39,8,23,13,83,normal
1:30:00 AM,19,Thursday,40,14,18,21,93,normal
1:45:00 AM,19,Thursday,49,1,35,18,103,normal
2:00:00 AM,19,Thursday,38,12,35,25,110,normal
2:15:00 AM,19,Thursday,26,15,25,6,72,normal
2:30:00 AM,19,Thursday,93,14,10,25,142,high
2:45:00 AM,19,Thursday,54,24,37,20,135,high
3:00:00 AM,19,Thursday,32,6,10,23,71,normal
3:15:00 AM,19,Thursday,43,7,12,23,85,normal
3:30:00 AM,19,Thursday,23,6,15,20,64,normal
3:45:00 AM,19,Thursday,26,5,8,25,64,normal
4:00:00 AM,19,Thursday,55,7,8,27,97,normal
4:15:00 AM,19,Thursday,70,10,8,25,113,high
4:30:00 AM,19,Thursday,66,10,3,29,108,normal
4:45:00 AM,19,Thursday,66,7,15,26,114,high
5:00:00 AM,19,Thursday,46,6,7,21,80,normal
5:15:00 AM,19,Thursday,47,26,6,20,99,normal
5:30:00 AM,19,Thursday,75,20,7,11,113,normal
5:45:00 AM,19,Thursday,76,29,15,19,139,normal
6:00:00 AM,19,Thursday,56,14,38,12,120,high
6:15:00 AM,19,Thursday,19,26,36,17,98,normal
6:30:00 AM,19,Thursday,29,18,10,9,66,low
6:45:00 AM,19,Thursday,15,12,18,15,60,normal
7:00:00 AM,19,Thursday,53,27,27,17,124,high
7:15:00 AM,19,Thursday,95,22,28,9,154,high
7:30:00 AM,19,Thursday,27,27,32,10,96,normal
7:45:00 AM,19,Thursday,68,28,31,15,142,high
8:00:00 AM,19,Thursday,120,14,25,8,167,normal
8:15:00 AM,19,Thursday,144,28,24,8,204,heavy
8:30:00 AM,19,Thursday,112,31,43,8,194,heavy
8:45:00 AM,19,Thursday,149,28,20,10,207,heavy
9:00:00 AM,19,Thursday,131,29,34,8,202,heavy
9:15:00 AM,19,Thursday,104,31,41,9,185,heavy
9:30:00 AM,19,Thursday,141,30,27,7,205,heavy
9:45:00 AM,19,Thursday,117,10,47,9,183,heavy
10:00:00 AM,19,Thursday,112,13,37,6,168,heavy
10:15:00 AM,19,Thursday,127,40,39,8,214,heavy
10:30:00 AM,19,Thursday,131,15,31,6,183,heavy
10:45:00 AM,19,Thursday,66,8,10,11,95,low
11:00:00 AM,19,Thursday,61,23,18,34,136,high
11:15:00 AM,19,Thursday,55,25,13,26,119,high
11:30:00 AM,19,Thursday,85,23,20,6,134,normal
11:45:00 AM,19,Thursday,75,20,19,19,133,normal
12:00:00 PM,19,Thursday,58,17,20,22,117,high
12:15:00 PM,19,Thursday,60,23,11,26,120,high
12:30:00 PM,19,Thursday,80,21,11,7,119,normal
12:45:00 PM,19,Thursday,74,9,14,35,132,high
1:00:00 PM,19,Thursday,57,14,11,16,98,normal
1:15:00 PM,19,Thursday,73,9,13,5,100,low
1:30:00 PM,19,Thursday,80,25,19,26,150,high
1:45:00 PM,19,Thursday,82,13,12,21,128,high
2:00:00 PM,19,Thursday,15,4,0,27,46,normal
2:15:00 PM,19,Thursday,20,2,0,29,51,normal
2:30:00 PM,19,Thursday,12,2,0,39,53,normal
2:45:00 PM,19,Thursday,10,4,1,13,28,normal
3:00:00 PM,19,Thursday,16,0,1,29,46,normal
3:15:00 PM,19,Thursday,18,0,0,34,52,normal
3:30:00 PM,19,Thursday,11,5,1,19,36,normal
3:45:00 PM,19,Thursday,16,1,0,12,29,low
4:00:00 PM,19,Thursday,13,3,1,12,29,low
4:15:00 PM,19,Thursday,19,2,0,22,43,normal
4:30:00 PM,19,Thursday,13,3,0,39,55,normal
4:45:00 PM,19,Thursday,12,0,0,24,36,normal
5:00:00 PM,19,Thursday,10,3,1,12,26,low
5:15:00 PM,19,Thursday,11,4,0,38,53,normal
5:30:00 PM,19,Thursday,18,4,0,31,53,normal
5:45:00 PM,19,Thursday,19,1,0,34,54,normal
6:00:00 PM,19,Thursday,18,1,0,27,46,normal
6:15:00 PM,19,Thursday,13,0,0,26,39,normal
6:30:00 PM,19,Thursday,12,2,0,35,49,normal
6:45:00 PM,19,Thursday,15,4,0,12,31,low
7:00:00 PM,19,Thursday,10,5,0,33,48,normal
7:15:00 PM,19,Thursday,14,0,0,15,29,normal
7:30:00 PM,19,Thursday,16,0,0,16,32,normal
7:45:00 PM,19,Thursday,15,3,1,26,45,normal
8:00:00 PM,19,Thursday,20,4,0,34,58,normal
8:15:00 PM,19,Thursday,82,20,10,11,123,normal
8:30:00 PM,19,Thursday,99,7,3,6,115,normal
8:45:00 PM,19,Thursday,74,29,9,4,116,normal
9:00:00 PM,19,Thursday,94,1,1,14,110,normal
9:15:00 PM,19,Thursday,63,12,10,17,102,normal
9:30:00 PM,19,Thursday,101,4,3,12,120,normal
9:45:00 PM,19,Thursday,106,9,3,10,128,normal
10:00:00 PM,19,Thursday,112,15,24,1,152,normal
10:15:00 PM,19,Thursday,148,26,25,0,199,heavy
10:30:00 PM,19,Thursday,115,20,31,3,169,heavy
10:45:00 PM,19,Thursday,125,11,24,0,160,normal
11:00:00 PM,19,Thursday,140,38,38,0,216,heavy
11:15:00 PM,19,Thursday,150,17,35,5,207,heavy
11:30:00 PM,19,Thursday,149,11,42,2,204,heavy
11:45:00 PM,19,Thursday,150,22,38,3,213,heavy
12:00:00 AM,20,Friday,147,32,25,4,208,heavy
12:15:00 AM,20,Friday,138,39,45,4,226,heavy
12:30:00 AM,20,Friday,149,16,49,1,215,heavy
12:45:00 AM,20,Friday,139,10,50,2,201,heavy
1:00:00 AM,20,Friday,109,25,49,2,185,heavy
1:15:00 AM,20,Friday,84,24,12,28,148,high
1:30:00 AM,20,Friday,38,8,6,5,57,low
1:45:00 AM,20,Friday,45,16,6,21,88,normal
2:00:00 AM,20,Friday,57,4,36,14,111,normal
2:15:00 AM,20,Friday,84,12,6,28,130,high
2:30:00 AM,20,Friday,55,25,33,21,134,high
2:45:00 AM,20,Friday,14,15,5,21,55,normal
3:00:00 AM,20,Friday,26,8,11,20,65,normal
3:15:00 AM,20,Friday,60,10,9,27,106,normal
3:30:00 AM,20,Friday,34,6,7,25,72,normal
3:45:00 AM,20,Friday,22,9,8,26,65,normal
4:00:00 AM,20,Friday,59,10,11,30,110,normal
4:15:00 AM,20,Friday,48,6,14,28,96,normal
4:30:00 AM,20,Friday,46,9,11,23,89,normal
4:45:00 AM,20,Friday,37,9,8,20,74,normal
5:00:00 AM,20,Friday,67,9,11,21,108,normal
5:15:00 AM,20,Friday,32,19,39,9,99,normal
5:30:00 AM,20,Friday,63,12,22,5,102,normal
5:45:00 AM,20,Friday,32,29,25,11,97,normal
6:00:00 AM,20,Friday,83,22,40,20,165,high
6:15:00 AM,20,Friday,40,14,31,19,104,normal
6:30:00 AM,20,Friday,101,22,39,19,181,heavy
6:45:00 AM,20,Friday,62,29,31,11,133,high
7:00:00 AM,20,Friday,20,19,25,8,72,normal
7:15:00 AM,20,Friday,42,22,5,9,78,low
7:30:00 AM,20,Friday,37,17,12,16,82,normal
7:45:00 AM,20,Friday,95,12,20,15,142,normal
